dep;jour;pc_vac_dose1;pc_vac_dose2;pc_vac_cum_dose1;pc_vac_cum_dose2
01;2020-12-28;0;0;0;0
01;2020-12-29;0;0;0;0
01;2020-12-30;0;0;0;0
01;2020-12-31;0;0;0;0
01;2021-01-01;0;0;0;0
01;2021-01-02;0;0;0;0
01;2021-01-03;0;0;0;0
01;2021-01-04;0;0;0;0
01;2021-01-05;0;0;0;0
01;2021-01-06;0;0;0;0
01;2021-01-07;2;0;2;0
01;2021-01-08;4;0;6;0
01;2021-01-09;0;0;6;0
01;2021-01-10;0;0;6;0
01;2021-01-11;10;0;16;0
01;2021-01-12;20;0;36;0
01;2021-01-13;32;0;68;0
01;2021-01-14;44;0;112;0
01;2021-01-15;33;0;145;0
01;2021-01-16;19;0;164;0
01;2021-01-17;27;0;191;0
01;2021-01-18;9;0;200;0
01;2021-01-19;25;0;225;0
01;2021-01-20;65;0;290;0
01;2021-01-21;40;0;330;0
01;2021-01-22;39;0;369;0
01;2021-01-23;3;0;372;0
01;2021-01-24;3;0;375;0
01;2021-01-25;24;1;399;1
01;2021-01-26;45;0;444;1
01;2021-01-27;21;0;465;1
01;2021-01-28;31;5;496;6
01;2021-01-29;40;1;536;7
01;2021-01-30;7;0;543;7
01;2021-01-31;0;0;543;7
01;2021-02-01;16;6;559;13
01;2021-02-02;28;14;587;27
01;2021-02-03;20;24;607;51
01;2021-02-04;23;39;630;90
01;2021-02-05;18;13;648;103
01;2021-02-06;8;13;656;116
01;2021-02-07;0;25;656;141
01;2021-02-08;31;12;687;153
01;2021-02-09;53;33;740;186
01;2021-02-10;45;62;785;248
01;2021-02-11;51;42;836;290
01;2021-02-12;54;41;890;331
01;2021-02-13;4;2;894;333
01;2021-02-14;0;0;894;333
01;2021-02-15;33;15;927;348
01;2021-02-16;36;17;963;365
01;2021-02-17;39;9;1002;374
01;2021-02-18;46;20;1048;394
01;2021-02-19;28;15;1076;409
01;2021-02-20;14;2;1090;411
01;2021-02-21;0;0;1090;411
01;2021-02-22;33;25;1123;436
01;2021-02-23;24;26;1147;462
01;2021-02-24;41;22;1188;484
01;2021-02-25;145;32;1333;516
01;2021-02-26;224;30;1557;546
01;2021-02-27;175;4;1732;550
01;2021-02-28;11;0;1743;550
01;2021-03-01;74;26;1817;576
01;2021-03-02;125;41;1942;617
01;2021-03-03;176;29;2118;646
01;2021-03-04;265;41;2383;687
01;2021-03-05;305;28;2688;715
01;2021-03-06;210;4;2898;719
01;2021-03-07;13;0;2911;719
01;2021-03-08;91;38;3002;757
01;2021-03-09;190;39;3192;796
01;2021-03-10;215;21;3407;817
01;2021-03-11;271;38;3678;855
01;2021-03-12;421;23;4099;878
01;2021-03-13;228;4;4327;882
01;2021-03-14;25;0;4352;882
01;2021-03-15;98;27;4450;909
01;2021-03-16;68;42;4518;951
01;2021-03-17;50;33;4568;984
01;2021-03-18;77;25;4645;1009
01;2021-03-19;237;28;4882;1037
01;2021-03-20;162;9;5044;1046
01;2021-03-21;16;0;5060;1046
01;2021-03-22;148;20;5208;1066
01;2021-03-23;289;28;5497;1094
01;2021-03-24;187;24;5684;1118
01;2021-03-25;397;18;6081;1136
01;2021-03-26;430;27;6511;1163
01;2021-03-27;168;4;6679;1167
01;2021-03-28;6;0;6685;1167
01;2021-03-29;203;20;6888;1187
01;2021-03-30;313;29;7201;1216
01;2021-03-31;208;21;7409;1237
01;2021-04-01;284;28;7693;1265
02;2020-12-28;0;0;0;0
02;2020-12-29;0;0;0;0
02;2020-12-30;0;0;0;0
02;2020-12-31;0;0;0;0
02;2021-01-01;0;0;0;0
02;2021-01-02;0;0;0;0
02;2021-01-03;0;0;0;0
02;2021-01-04;0;0;0;0
02;2021-01-05;0;0;0;0
02;2021-01-06;6;0;6;0
02;2021-01-07;47;0;53;0
02;2021-01-08;68;0;121;0
02;2021-01-09;18;0;139;0
02;2021-01-10;6;0;145;0
02;2021-01-11;43;0;188;0
02;2021-01-12;41;0;229;0
02;2021-01-13;63;0;292;0
02;2021-01-14;79;0;371;0
02;2021-01-15;58;0;429;0
02;2021-01-16;35;1;464;1
02;2021-01-17;6;0;470;1
02;2021-01-18;49;0;519;1
02;2021-01-19;53;0;572;1
02;2021-01-20;78;0;650;1
02;2021-01-21;173;0;823;1
02;2021-01-22;85;0;908;1
02;2021-01-23;19;0;927;1
02;2021-01-24;8;0;935;1
02;2021-01-25;24;3;959;4
02;2021-01-26;48;7;1007;11
02;2021-01-27;9;3;1016;14
02;2021-01-28;4;37;1020;51
02;2021-01-29;4;70;1024;121
02;2021-01-30;2;2;1026;123
02;2021-01-31;0;0;1026;123
02;2021-02-01;0;46;1026;169
02;2021-02-02;4;39;1030;208
02;2021-02-03;8;49;1038;257
02;2021-02-04;15;38;1053;295
02;2021-02-05;15;34;1068;329
02;2021-02-06;9;21;1077;350
02;2021-02-07;0;0;1077;350
02;2021-02-08;24;44;1101;394
02;2021-02-09;18;43;1119;437
02;2021-02-10;34;75;1153;512
02;2021-02-11;50;146;1203;658
02;2021-02-12;71;94;1274;752
02;2021-02-13;34;10;1308;762
02;2021-02-14;0;0;1308;762
02;2021-02-15;21;42;1329;804
02;2021-02-16;41;30;1370;834
02;2021-02-17;54;41;1424;875
02;2021-02-18;36;23;1460;898
02;2021-02-19;33;24;1493;922
02;2021-02-20;33;9;1526;931
02;2021-02-21;5;3;1531;934
02;2021-02-22;41;10;1572;944
02;2021-02-23;27;26;1599;970
02;2021-02-24;60;5;1659;975
02;2021-02-25;175;8;1834;983
02;2021-02-26;190;11;2024;994
02;2021-02-27;197;0;2221;994
02;2021-02-28;31;0;2252;994
02;2021-03-01;63;4;2315;998
02;2021-03-02;126;8;2441;1006
02;2021-03-03;182;15;2623;1021
02;2021-03-04;286;38;2909;1059
02;2021-03-05;222;27;3131;1086
02;2021-03-06;418;6;3549;1092
02;2021-03-07;119;3;3668;1095
02;2021-03-08;54;22;3722;1117
02;2021-03-09;153;19;3875;1136
02;2021-03-10;153;31;4028;1167
02;2021-03-11;238;22;4266;1189
02;2021-03-12;291;34;4557;1223
02;2021-03-13;470;34;5027;1257
02;2021-03-14;216;0;5243;1257
02;2021-03-15;66;26;5309;1283
02;2021-03-16;85;35;5394;1318
02;2021-03-17;58;38;5452;1356
02;2021-03-18;54;28;5506;1384
02;2021-03-19;168;17;5674;1401
02;2021-03-20;371;5;6045;1406
02;2021-03-21;215;6;6260;1412
02;2021-03-22;95;40;6355;1452
02;2021-03-23;160;29;6515;1481
02;2021-03-24;284;23;6799;1504
02;2021-03-25;338;27;7137;1531
02;2021-03-26;389;18;7526;1549
02;2021-03-27;309;3;7835;1552
02;2021-03-28;55;10;7890;1562
02;2021-03-29;154;47;8044;1609
02;2021-03-30;231;48;8275;1657
02;2021-03-31;216;48;8491;1705
02;2021-04-01;151;46;8642;1751
03;2020-12-28;0;0;0;0
03;2020-12-29;0;0;0;0
03;2020-12-30;0;0;0;0
03;2020-12-31;0;0;0;0
03;2021-01-01;0;0;0;0
03;2021-01-02;0;0;0;0
03;2021-01-03;0;0;0;0
03;2021-01-04;0;0;0;0
03;2021-01-05;0;0;0;0
03;2021-01-06;0;0;0;0
03;2021-01-07;7;0;7;0
03;2021-01-08;12;0;19;0
03;2021-01-09;5;0;24;0
03;2021-01-10;0;0;24;0
03;2021-01-11;48;0;72;0
03;2021-01-12;66;0;138;0
03;2021-01-13;79;0;217;0
03;2021-01-14;94;0;311;0
03;2021-01-15;23;0;334;0
03;2021-01-16;33;0;367;0
03;2021-01-17;1;0;368;0
03;2021-01-18;32;0;400;0
03;2021-01-19;46;0;446;0
03;2021-01-20;64;0;510;0
03;2021-01-21;53;0;563;0
03;2021-01-22;64;0;627;0
03;2021-01-23;22;0;649;0
03;2021-01-24;0;0;649;0
03;2021-01-25;11;0;660;0
03;2021-01-26;43;0;703;0
03;2021-01-27;22;0;725;0
03;2021-01-28;46;5;771;5
03;2021-01-29;54;12;825;17
03;2021-01-30;40;3;865;20
03;2021-01-31;0;0;865;20
03;2021-02-01;9;5;874;25
03;2021-02-02;26;30;900;55
03;2021-02-03;41;36;941;91
03;2021-02-04;53;71;994;162
03;2021-02-05;38;40;1032;202
03;2021-02-06;16;5;1048;207
03;2021-02-07;1;2;1049;209
03;2021-02-08;7;7;1056;216
03;2021-02-09;28;26;1084;242
03;2021-02-10;20;30;1104;272
03;2021-02-11;73;69;1177;341
03;2021-02-12;69;35;1246;376
03;2021-02-13;10;11;1256;387
03;2021-02-14;0;0;1256;387
03;2021-02-15;31;39;1287;426
03;2021-02-16;44;51;1331;477
03;2021-02-17;43;94;1374;571
03;2021-02-18;25;62;1399;633
03;2021-02-19;63;47;1462;680
03;2021-02-20;43;17;1505;697
03;2021-02-21;0;0;1505;697
03;2021-02-22;11;12;1516;709
03;2021-02-23;100;34;1616;743
03;2021-02-24;77;40;1693;783
03;2021-02-25;173;73;1866;856
03;2021-02-26;115;78;1981;934
03;2021-02-27;38;13;2019;947
03;2021-02-28;0;0;2019;947
03;2021-03-01;26;11;2045;958
03;2021-03-02;182;26;2227;984
03;2021-03-03;133;16;2360;1000
03;2021-03-04;208;32;2568;1032
03;2021-03-05;153;25;2721;1057
03;2021-03-06;216;10;2937;1067
03;2021-03-07;1;0;2938;1067
03;2021-03-08;29;17;2967;1084
03;2021-03-09;182;9;3149;1093
03;2021-03-10;156;20;3305;1113
03;2021-03-11;185;31;3490;1144
03;2021-03-12;188;42;3678;1186
03;2021-03-13;186;6;3864;1192
03;2021-03-14;0;0;3864;1192
03;2021-03-15;24;12;3888;1204
03;2021-03-16;51;10;3939;1214
03;2021-03-17;103;24;4042;1238
03;2021-03-18;121;31;4163;1269
03;2021-03-19;169;30;4332;1299
03;2021-03-20;43;1;4375;1300
03;2021-03-21;0;0;4375;1300
03;2021-03-22;22;26;4397;1326
03;2021-03-23;166;7;4563;1333
03;2021-03-24;205;23;4768;1356
03;2021-03-25;226;30;4994;1386
03;2021-03-26;266;35;5260;1421
03;2021-03-27;89;1;5349;1422
03;2021-03-28;0;0;5349;1422
03;2021-03-29;119;13;5468;1435
03;2021-03-30;238;20;5706;1455
03;2021-03-31;124;58;5830;1513
03;2021-04-01;140;75;5970;1588
04;2020-12-28;0;0;0;0
04;2020-12-29;0;0;0;0
04;2020-12-30;0;0;0;0
04;2020-12-31;0;0;0;0
04;2021-01-01;0;0;0;0
04;2021-01-02;0;0;0;0
04;2021-01-03;0;0;0;0
04;2021-01-04;0;0;0;0
04;2021-01-05;0;0;0;0
04;2021-01-06;0;0;0;0
04;2021-01-07;3;0;3;0
04;2021-01-08;14;0;17;0
04;2021-01-09;1;0;18;0
04;2021-01-10;0;0;18;0
04;2021-01-11;4;0;22;0
04;2021-01-12;29;0;51;0
04;2021-01-13;19;0;70;0
04;2021-01-14;12;0;82;0
04;2021-01-15;19;0;101;0
04;2021-01-16;18;0;119;0
04;2021-01-17;0;0;119;0
04;2021-01-18;18;0;137;0
04;2021-01-19;25;0;162;0
04;2021-01-20;20;1;182;1
04;2021-01-21;32;0;214;1
04;2021-01-22;34;0;248;1
04;2021-01-23;8;0;256;1
04;2021-01-24;0;0;256;1
04;2021-01-25;19;0;275;1
04;2021-01-26;22;0;297;1
04;2021-01-27;20;0;317;1
04;2021-01-28;29;4;346;5
04;2021-01-29;32;9;378;14
04;2021-01-30;4;0;382;14
04;2021-01-31;0;0;382;14
04;2021-02-01;8;6;390;20
04;2021-02-02;28;16;418;36
04;2021-02-03;16;12;434;48
04;2021-02-04;8;9;442;57
04;2021-02-05;19;26;461;83
04;2021-02-06;4;9;465;92
04;2021-02-07;0;1;465;93
04;2021-02-08;7;6;472;99
04;2021-02-09;10;12;482;111
04;2021-02-10;12;8;494;119
04;2021-02-11;9;22;503;141
04;2021-02-12;8;17;511;158
04;2021-02-13;1;5;512;163
04;2021-02-14;0;0;512;163
04;2021-02-15;1;11;513;174
04;2021-02-16;8;25;521;199
04;2021-02-17;0;15;521;214
04;2021-02-18;3;31;524;245
04;2021-02-19;5;24;529;269
04;2021-02-20;2;3;531;272
04;2021-02-21;0;0;531;272
04;2021-02-22;2;17;533;289
04;2021-02-23;3;21;536;310
04;2021-02-24;1;20;537;330
04;2021-02-25;16;15;553;345
04;2021-02-26;79;25;632;370
04;2021-02-27;71;6;703;376
04;2021-02-28;0;0;703;376
04;2021-03-01;1;7;704;383
04;2021-03-02;43;3;747;386
04;2021-03-03;93;25;840;411
04;2021-03-04;51;10;891;421
04;2021-03-05;57;13;948;434
04;2021-03-06;130;5;1078;439
04;2021-03-07;45;0;1123;439
04;2021-03-08;10;4;1133;443
04;2021-03-09;50;9;1183;452
04;2021-03-10;58;12;1241;464
04;2021-03-11;63;13;1304;477
04;2021-03-12;109;7;1413;484
04;2021-03-13;102;6;1515;490
04;2021-03-14;34;0;1549;490
04;2021-03-15;4;0;1553;490
04;2021-03-16;7;1;1560;491
04;2021-03-17;25;5;1585;496
04;2021-03-18;60;0;1645;496
04;2021-03-19;72;1;1717;497
04;2021-03-20;18;0;1735;497
04;2021-03-21;0;0;1735;497
04;2021-03-22;16;2;1751;499
04;2021-03-23;22;0;1773;499
04;2021-03-24;93;4;1866;503
04;2021-03-25;134;2;2000;505
04;2021-03-26;120;1;2120;506
04;2021-03-27;36;0;2156;506
04;2021-03-28;0;0;2156;506
04;2021-03-29;77;1;2233;507
04;2021-03-30;108;1;2341;508
04;2021-03-31;132;5;2473;513
04;2021-04-01;106;6;2579;519
05;2020-12-28;0;0;0;0
05;2020-12-29;0;0;0;0
05;2020-12-30;0;0;0;0
05;2020-12-31;0;0;0;0
05;2021-01-01;0;0;0;0
05;2021-01-02;0;0;0;0
05;2021-01-03;0;0;0;0
05;2021-01-04;0;0;0;0
05;2021-01-05;0;0;0;0
05;2021-01-06;1;0;1;0
05;2021-01-07;5;0;6;0
05;2021-01-08;9;0;15;0
05;2021-01-09;0;0;15;0
05;2021-01-10;0;0;15;0
05;2021-01-11;6;0;21;0
05;2021-01-12;12;0;33;0
05;2021-01-13;15;0;48;0
05;2021-01-14;14;0;62;0
05;2021-01-15;16;0;78;0
05;2021-01-16;2;0;80;0
05;2021-01-17;0;0;80;0
05;2021-01-18;8;0;88;0
05;2021-01-19;14;0;102;0
05;2021-01-20;10;0;112;0
05;2021-01-21;17;0;129;0
05;2021-01-22;8;0;137;0
05;2021-01-23;3;0;140;0
05;2021-01-24;0;0;140;0
05;2021-01-25;17;0;157;0
05;2021-01-26;30;0;187;0
05;2021-01-27;22;0;209;0
05;2021-01-28;26;1;235;1
05;2021-01-29;24;7;259;8
05;2021-01-30;1;0;260;8
05;2021-01-31;0;0;260;8
05;2021-02-01;12;3;272;11
05;2021-02-02;5;11;277;22
05;2021-02-03;18;7;295;29
05;2021-02-04;7;9;302;38
05;2021-02-05;12;12;314;50
05;2021-02-06;3;1;317;51
05;2021-02-07;0;0;317;51
05;2021-02-08;4;4;321;55
05;2021-02-09;1;9;322;64
05;2021-02-10;2;8;324;72
05;2021-02-11;2;18;326;90
05;2021-02-12;2;13;328;103
05;2021-02-13;0;3;328;106
05;2021-02-14;0;0;328;106
05;2021-02-15;4;9;332;115
05;2021-02-16;7;32;339;147
05;2021-02-17;6;17;345;164
05;2021-02-18;5;13;350;177
05;2021-02-19;11;20;361;197
05;2021-02-20;0;5;361;202
05;2021-02-21;0;0;361;202
05;2021-02-22;1;11;362;213
05;2021-02-23;0;8;362;221
05;2021-02-24;0;15;362;236
05;2021-02-25;22;12;384;248
05;2021-02-26;44;10;428;258
05;2021-02-27;13;3;441;261
05;2021-02-28;4;0;445;261
05;2021-03-01;14;8;459;269
05;2021-03-02;24;5;483;274
05;2021-03-03;39;16;522;290
05;2021-03-04;53;9;575;299
05;2021-03-05;89;4;664;303
05;2021-03-06;66;2;730;305
05;2021-03-07;35;0;765;305
05;2021-03-08;41;3;806;308
05;2021-03-09;45;5;851;313
05;2021-03-10;57;5;908;318
05;2021-03-11;61;2;969;320
05;2021-03-12;79;5;1048;325
05;2021-03-13;50;0;1098;325
05;2021-03-14;32;0;1130;325
05;2021-03-15;41;10;1171;335
05;2021-03-16;10;2;1181;337
05;2021-03-17;8;5;1189;342
05;2021-03-18;18;0;1207;342
05;2021-03-19;48;2;1255;344
05;2021-03-20;16;1;1271;345
05;2021-03-21;0;0;1271;345
05;2021-03-22;47;1;1318;346
05;2021-03-23;51;0;1369;346
05;2021-03-24;80;2;1449;348
05;2021-03-25;95;0;1544;348
05;2021-03-26;114;0;1658;348
05;2021-03-27;42;1;1700;349
05;2021-03-28;2;0;1702;349
05;2021-03-29;91;1;1793;350
05;2021-03-30;117;1;1910;351
05;2021-03-31;66;10;1976;361
05;2021-04-01;76;3;2052;364
06;2020-12-28;0;0;0;0
06;2020-12-29;0;0;0;0
06;2020-12-30;0;0;0;0
06;2020-12-31;0;0;0;0
06;2021-01-01;2;0;2;0
06;2021-01-02;0;0;2;0
06;2021-01-03;1;0;3;0
06;2021-01-04;14;0;17;0
06;2021-01-05;19;0;36;0
06;2021-01-06;21;0;57;0
06;2021-01-07;54;0;111;0
06;2021-01-08;90;0;201;0
06;2021-01-09;54;0;255;0
06;2021-01-10;8;0;263;0
06;2021-01-11;93;0;356;0
06;2021-01-12;171;0;527;0
06;2021-01-13;141;0;668;0
06;2021-01-14;152;0;820;0
06;2021-01-15;96;0;916;0
06;2021-01-16;30;0;946;0
06;2021-01-17;1;0;947;0
06;2021-01-18;102;0;1049;0
06;2021-01-19;151;0;1200;0
06;2021-01-20;142;0;1342;0
06;2021-01-21;158;0;1500;0
06;2021-01-22;122;0;1622;0
06;2021-01-23;46;0;1668;0
06;2021-01-24;0;0;1668;0
06;2021-01-25;97;4;1765;4
06;2021-01-26;119;9;1884;13
06;2021-01-27;98;27;1982;40
06;2021-01-28;138;34;2120;74
06;2021-01-29;111;58;2231;132
06;2021-01-30;9;9;2240;141
06;2021-01-31;0;0;2240;141
06;2021-02-01;31;59;2271;200
06;2021-02-02;31;34;2302;234
06;2021-02-03;31;27;2333;261
06;2021-02-04;34;151;2367;412
06;2021-02-05;77;176;2444;588
06;2021-02-06;9;71;2453;659
06;2021-02-07;0;0;2453;659
06;2021-02-08;48;110;2501;769
06;2021-02-09;27;97;2528;866
06;2021-02-10;36;71;2564;937
06;2021-02-11;80;88;2644;1025
06;2021-02-12;73;105;2717;1130
06;2021-02-13;5;19;2722;1149
06;2021-02-14;0;0;2722;1149
06;2021-02-15;53;129;2775;1278
06;2021-02-16;92;143;2867;1421
06;2021-02-17;82;133;2949;1554
06;2021-02-18;108;161;3057;1715
06;2021-02-19;97;115;3154;1830
06;2021-02-20;20;21;3174;1851
06;2021-02-21;2;0;3176;1851
06;2021-02-22;60;52;3236;1903
06;2021-02-23;110;43;3346;1946
06;2021-02-24;94;33;3440;1979
06;2021-02-25;342;77;3782;2056
06;2021-02-26;397;72;4179;2128
06;2021-02-27;228;12;4407;2140
06;2021-02-28;17;0;4424;2140
06;2021-03-01;230;58;4654;2198
06;2021-03-02;362;52;5016;2250
06;2021-03-03;320;31;5336;2281
06;2021-03-04;588;75;5924;2356
06;2021-03-05;542;59;6466;2415
06;2021-03-06;1220;1;7686;2416
06;2021-03-07;849;0;8535;2416
06;2021-03-08;302;42;8837;2458
06;2021-03-09;468;69;9305;2527
06;2021-03-10;499;64;9804;2591
06;2021-03-11;625;87;10429;2678
06;2021-03-12;741;70;11170;2748
06;2021-03-13;1157;3;12327;2751
06;2021-03-14;58;0;12385;2751
06;2021-03-15;355;31;12740;2782
06;2021-03-16;238;68;12978;2850
06;2021-03-17;370;60;13348;2910
06;2021-03-18;353;88;13701;2998
06;2021-03-19;531;78;14232;3076
06;2021-03-20;275;15;14507;3091
06;2021-03-21;52;0;14559;3091
06;2021-03-22;381;54;14940;3145
06;2021-03-23;613;77;15553;3222
06;2021-03-24;550;70;16103;3292
06;2021-03-25;658;92;16761;3384
06;2021-03-26;721;98;17482;3482
06;2021-03-27;255;13;17737;3495
06;2021-03-28;38;0;17775;3495
06;2021-03-29;287;88;18062;3583
06;2021-03-30;544;82;18606;3665
06;2021-03-31;647;78;19253;3743
06;2021-04-01;712;85;19965;3828
07;2020-12-28;0;0;0;0
07;2020-12-29;0;0;0;0
07;2020-12-30;0;0;0;0
07;2020-12-31;0;0;0;0
07;2021-01-01;1;0;1;0
07;2021-01-02;0;0;1;0
07;2021-01-03;0;0;1;0
07;2021-01-04;0;0;1;0
07;2021-01-05;0;0;1;0
07;2021-01-06;3;0;4;0
07;2021-01-07;5;0;9;0
07;2021-01-08;4;0;13;0
07;2021-01-09;7;0;20;0
07;2021-01-10;0;0;20;0
07;2021-01-11;8;0;28;0
07;2021-01-12;34;0;62;0
07;2021-01-13;25;0;87;0
07;2021-01-14;41;0;128;0
07;2021-01-15;21;0;149;0
07;2021-01-16;0;0;149;0
07;2021-01-17;0;0;149;0
07;2021-01-18;11;0;160;0
07;2021-01-19;72;0;232;0
07;2021-01-20;43;0;275;0
07;2021-01-21;30;0;305;0
07;2021-01-22;16;0;321;0
07;2021-01-23;6;0;327;0
07;2021-01-24;0;0;327;0
07;2021-01-25;8;0;335;0
07;2021-01-26;21;0;356;0
07;2021-01-27;20;3;376;3
07;2021-01-28;49;7;425;10
07;2021-01-29;45;6;470;16
07;2021-01-30;17;2;487;18
07;2021-01-31;0;0;487;18
07;2021-02-01;13;8;500;26
07;2021-02-02;36;26;536;52
07;2021-02-03;45;14;581;66
07;2021-02-04;39;34;620;100
07;2021-02-05;26;25;646;125
07;2021-02-06;2;1;648;126
07;2021-02-07;1;0;649;126
07;2021-02-08;12;8;661;134
07;2021-02-09;15;39;676;173
07;2021-02-10;24;55;700;228
07;2021-02-11;12;30;712;258
07;2021-02-12;11;6;723;264
07;2021-02-13;1;2;724;266
07;2021-02-14;0;0;724;266
07;2021-02-15;12;4;736;270
07;2021-02-16;11;12;747;282
07;2021-02-17;22;15;769;297
07;2021-02-18;27;33;796;330
07;2021-02-19;30;42;826;372
07;2021-02-20;5;3;831;375
07;2021-02-21;0;0;831;375
07;2021-02-22;16;3;847;378
07;2021-02-23;36;43;883;421
07;2021-02-24;82;42;965;463
07;2021-02-25;97;30;1062;493
07;2021-02-26;188;13;1250;506
07;2021-02-27;52;16;1302;522
07;2021-02-28;0;0;1302;522
07;2021-03-01;46;5;1348;527
07;2021-03-02;74;18;1422;545
07;2021-03-03;99;18;1521;563
07;2021-03-04;202;21;1723;584
07;2021-03-05;262;17;1985;601
07;2021-03-06;178;1;2163;602
07;2021-03-07;83;0;2246;602
07;2021-03-08;24;13;2270;615
07;2021-03-09;119;10;2389;625
07;2021-03-10;101;15;2490;640
07;2021-03-11;196;15;2686;655
07;2021-03-12;227;25;2913;680
07;2021-03-13;95;3;3008;683
07;2021-03-14;0;0;3008;683
07;2021-03-15;42;8;3050;691
07;2021-03-16;94;16;3144;707
07;2021-03-17;57;30;3201;737
07;2021-03-18;91;17;3292;754
07;2021-03-19;116;22;3408;776
07;2021-03-20;69;4;3477;780
07;2021-03-21;0;0;3477;780
07;2021-03-22;83;23;3560;803
07;2021-03-23;132;28;3692;831
07;2021-03-24;140;40;3832;871
07;2021-03-25;207;20;4039;891
07;2021-03-26;210;19;4249;910
07;2021-03-27;50;2;4299;912
07;2021-03-28;1;0;4300;912
07;2021-03-29;92;10;4392;922
07;2021-03-30;158;28;4550;950
07;2021-03-31;172;31;4722;981
07;2021-04-01;162;34;4884;1015
08;2020-12-28;0;0;0;0
08;2020-12-29;0;0;0;0
08;2020-12-30;0;0;0;0
08;2020-12-31;0;0;0;0
08;2021-01-01;0;0;0;0
08;2021-01-02;0;0;0;0
08;2021-01-03;0;0;0;0
08;2021-01-04;6;0;6;0
08;2021-01-05;0;0;6;0
08;2021-01-06;0;0;6;0
08;2021-01-07;10;0;16;0
08;2021-01-08;52;0;68;0
08;2021-01-09;15;0;83;0
08;2021-01-10;0;0;83;0
08;2021-01-11;17;0;100;0
08;2021-01-12;28;0;128;0
08;2021-01-13;61;0;189;0
08;2021-01-14;48;0;237;0
08;2021-01-15;42;0;279;0
08;2021-01-16;13;0;292;0
08;2021-01-17;0;0;292;0
08;2021-01-18;18;0;310;0
08;2021-01-19;60;0;370;0
08;2021-01-20;54;0;424;0
08;2021-01-21;45;0;469;0
08;2021-01-22;51;0;520;0
08;2021-01-23;15;0;535;0
08;2021-01-24;0;0;535;0
08;2021-01-25;11;0;546;0
08;2021-01-26;14;0;560;0
08;2021-01-27;19;0;579;0
08;2021-01-28;41;12;620;12
08;2021-01-29;47;45;667;57
08;2021-01-30;16;6;683;63
08;2021-01-31;0;0;683;63
08;2021-02-01;4;6;687;69
08;2021-02-02;13;28;700;97
08;2021-02-03;9;35;709;132
08;2021-02-04;20;38;729;170
08;2021-02-05;32;44;761;214
08;2021-02-06;12;10;773;224
08;2021-02-07;0;0;773;224
08;2021-02-08;2;21;775;245
08;2021-02-09;15;65;790;310
08;2021-02-10;33;55;823;365
08;2021-02-11;28;29;851;394
08;2021-02-12;44;27;895;421
08;2021-02-13;7;10;902;431
08;2021-02-14;0;0;902;431
08;2021-02-15;16;3;918;434
08;2021-02-16;9;18;927;452
08;2021-02-17;7;13;934;465
08;2021-02-18;14;37;948;502
08;2021-02-19;30;32;978;534
08;2021-02-20;0;12;978;546
08;2021-02-21;0;0;978;546
08;2021-02-22;12;8;990;554
08;2021-02-23;21;16;1011;570
08;2021-02-24;16;21;1027;591
08;2021-02-25;179;29;1206;620
08;2021-02-26;215;48;1421;668
08;2021-02-27;135;13;1556;681
08;2021-02-28;11;0;1567;681
08;2021-03-01;26;4;1593;685
08;2021-03-02;117;11;1710;696
08;2021-03-03;183;15;1893;711
08;2021-03-04;163;17;2056;728
08;2021-03-05;188;36;2244;764
08;2021-03-06;224;9;2468;773
08;2021-03-07;8;0;2476;773
08;2021-03-08;47;8;2523;781
08;2021-03-09;97;8;2620;789
08;2021-03-10;161;3;2781;792
08;2021-03-11;183;17;2964;809
08;2021-03-12;314;24;3278;833
08;2021-03-13;160;5;3438;838
08;2021-03-14;3;0;3441;838
08;2021-03-15;42;2;3483;840
08;2021-03-16;43;3;3526;843
08;2021-03-17;66;9;3592;852
08;2021-03-18;64;13;3656;865
08;2021-03-19;126;21;3782;886
08;2021-03-20;100;1;3882;887
08;2021-03-21;1;0;3883;887
08;2021-03-22;55;1;3938;888
08;2021-03-23;88;3;4026;891
08;2021-03-24;197;1;4223;892
08;2021-03-25;313;8;4536;900
08;2021-03-26;349;7;4885;907
08;2021-03-27;168;5;5053;912
08;2021-03-28;27;0;5080;912
08;2021-03-29;50;13;5130;925
08;2021-03-30;153;32;5283;957
08;2021-03-31;142;33;5425;990
08;2021-04-01;251;23;5676;1013
09;2020-12-28;0;0;0;0
09;2020-12-29;0;0;0;0
09;2020-12-30;0;0;0;0
09;2020-12-31;0;0;0;0
09;2021-01-01;0;0;0;0
09;2021-01-02;0;0;0;0
09;2021-01-03;0;0;0;0
09;2021-01-04;0;0;0;0
09;2021-01-05;0;0;0;0
09;2021-01-06;0;0;0;0
09;2021-01-07;12;0;12;0
09;2021-01-08;14;0;26;0
09;2021-01-09;9;0;35;0
09;2021-01-10;7;0;42;0
09;2021-01-11;15;0;57;0
09;2021-01-12;18;0;75;0
09;2021-01-13;14;0;89;0
09;2021-01-14;22;0;111;0
09;2021-01-15;10;0;121;0
09;2021-01-16;14;0;135;0
09;2021-01-17;5;0;140;0
09;2021-01-18;8;0;148;0
09;2021-01-19;17;0;165;0
09;2021-01-20;10;0;175;0
09;2021-01-21;12;0;187;0
09;2021-01-22;8;0;195;0
09;2021-01-23;4;0;199;0
09;2021-01-24;7;0;206;0
09;2021-01-25;11;1;217;1
09;2021-01-26;25;4;242;5
09;2021-01-27;29;3;271;8
09;2021-01-28;11;10;282;18
09;2021-01-29;6;11;288;29
09;2021-01-30;10;7;298;36
09;2021-01-31;4;1;302;37
09;2021-02-01;4;10;306;47
09;2021-02-02;5;14;311;61
09;2021-02-03;5;12;316;73
09;2021-02-04;3;16;319;89
09;2021-02-05;6;13;325;102
09;2021-02-06;6;2;331;104
09;2021-02-07;0;3;331;107
09;2021-02-08;4;13;335;120
09;2021-02-09;3;17;338;137
09;2021-02-10;0;7;338;144
09;2021-02-11;0;9;338;153
09;2021-02-12;13;7;351;160
09;2021-02-13;0;8;351;168
09;2021-02-14;0;3;351;171
09;2021-02-15;7;8;358;179
09;2021-02-16;15;25;373;204
09;2021-02-17;8;17;381;221
09;2021-02-18;5;21;386;242
09;2021-02-19;4;7;390;249
09;2021-02-20;3;8;393;257
09;2021-02-21;0;2;393;259
09;2021-02-22;9;6;402;265
09;2021-02-23;7;10;409;275
09;2021-02-24;11;6;420;281
09;2021-02-25;43;6;463;287
09;2021-02-26;34;13;497;300
09;2021-02-27;14;4;511;304
09;2021-02-28;5;1;516;305
09;2021-03-01;36;6;552;311
09;2021-03-02;43;5;595;316
09;2021-03-03;31;7;626;323
09;2021-03-04;75;0;701;323
09;2021-03-05;55;3;756;326
09;2021-03-06;61;5;817;331
09;2021-03-07;15;0;832;331
09;2021-03-08;25;6;857;337
09;2021-03-09;46;8;903;345
09;2021-03-10;58;5;961;350
09;2021-03-11;90;2;1051;352
09;2021-03-12;99;4;1150;356
09;2021-03-13;45;1;1195;357
09;2021-03-14;10;0;1205;357
09;2021-03-15;27;5;1232;362
09;2021-03-16;20;4;1252;366
09;2021-03-17;27;5;1279;371
09;2021-03-18;37;0;1316;371
09;2021-03-19;45;2;1361;373
09;2021-03-20;31;1;1392;374
09;2021-03-21;7;0;1399;374
09;2021-03-22;32;8;1431;382
09;2021-03-23;54;7;1485;389
09;2021-03-24;88;4;1573;393
09;2021-03-25;97;7;1670;400
09;2021-03-26;94;2;1764;402
09;2021-03-27;59;4;1823;406
09;2021-03-28;16;2;1839;408
09;2021-03-29;53;13;1892;421
09;2021-03-30;76;4;1968;425
09;2021-03-31;78;1;2046;426
09;2021-04-01;69;16;2115;442
10;2020-12-28;0;0;0;0
10;2020-12-29;0;0;0;0
10;2020-12-30;0;0;0;0
10;2020-12-31;0;0;0;0
10;2021-01-01;0;0;0;0
10;2021-01-02;0;0;0;0
10;2021-01-03;0;0;0;0
10;2021-01-04;0;0;0;0
10;2021-01-05;0;0;0;0
10;2021-01-06;0;0;0;0
10;2021-01-07;9;0;9;0
10;2021-01-08;13;0;22;0
10;2021-01-09;0;0;22;0
10;2021-01-10;0;0;22;0
10;2021-01-11;6;0;28;0
10;2021-01-12;17;0;45;0
10;2021-01-13;29;0;74;0
10;2021-01-14;28;0;102;0
10;2021-01-15;28;0;130;0
10;2021-01-16;5;2;135;2
10;2021-01-17;0;0;135;2
10;2021-01-18;14;0;149;2
10;2021-01-19;29;0;178;2
10;2021-01-20;31;0;209;2
10;2021-01-21;35;0;244;2
10;2021-01-22;37;0;281;2
10;2021-01-23;8;0;289;2
10;2021-01-24;0;0;289;2
10;2021-01-25;1;0;290;2
10;2021-01-26;3;0;293;2
10;2021-01-27;6;1;299;3
10;2021-01-28;5;10;304;13
10;2021-01-29;4;11;308;24
10;2021-01-30;0;0;308;24
10;2021-01-31;0;0;308;24
10;2021-02-01;7;9;315;33
10;2021-02-02;2;12;317;45
10;2021-02-03;6;30;323;75
10;2021-02-04;8;16;331;91
10;2021-02-05;8;25;339;116
10;2021-02-06;0;4;339;120
10;2021-02-07;0;0;339;120
10;2021-02-08;6;7;345;127
10;2021-02-09;12;25;357;152
10;2021-02-10;21;27;378;179
10;2021-02-11;34;19;412;198
10;2021-02-12;15;37;427;235
10;2021-02-13;3;6;430;241
10;2021-02-14;0;0;430;241
10;2021-02-15;6;6;436;247
10;2021-02-16;6;9;442;256
10;2021-02-17;8;12;450;268
10;2021-02-18;5;13;455;281
10;2021-02-19;9;7;464;288
10;2021-02-20;1;5;465;293
10;2021-02-21;0;0;465;293
10;2021-02-22;3;2;468;295
10;2021-02-23;4;4;472;299
10;2021-02-24;1;4;473;303
10;2021-02-25;70;6;543;309
10;2021-02-26;58;3;601;312
10;2021-02-27;43;2;644;314
10;2021-02-28;0;0;644;314
10;2021-03-01;20;2;664;316
10;2021-03-02;29;15;693;331
10;2021-03-03;39;23;732;354
10;2021-03-04;59;14;791;368
10;2021-03-05;53;5;844;373
10;2021-03-06;99;2;943;375
10;2021-03-07;44;0;987;375
10;2021-03-08;21;6;1008;381
10;2021-03-09;46;8;1054;389
10;2021-03-10;42;7;1096;396
10;2021-03-11;91;6;1187;402
10;2021-03-12;132;1;1319;403
10;2021-03-13;93;2;1412;405
10;2021-03-14;96;0;1508;405
10;2021-03-15;36;0;1544;405
10;2021-03-16;19;0;1563;405
10;2021-03-17;26;1;1589;406
10;2021-03-18;22;0;1611;406
10;2021-03-19;42;2;1653;408
10;2021-03-20;37;1;1690;409
10;2021-03-21;158;0;1848;409
10;2021-03-22;45;1;1893;410
10;2021-03-23;70;2;1963;412
10;2021-03-24;80;0;2043;412
10;2021-03-25;107;7;2150;419
10;2021-03-26;110;0;2260;419
10;2021-03-27;58;6;2318;425
10;2021-03-28;103;0;2421;425
10;2021-03-29;34;8;2455;433
10;2021-03-30;55;7;2510;440
10;2021-03-31;28;9;2538;449
10;2021-04-01;49;13;2587;462
11;2020-12-28;0;0;0;0
11;2020-12-29;0;0;0;0
11;2020-12-30;0;0;0;0
11;2020-12-31;0;0;0;0
11;2021-01-01;0;0;0;0
11;2021-01-02;1;0;1;0
11;2021-01-03;0;0;1;0
11;2021-01-04;0;0;1;0
11;2021-01-05;8;0;9;0
11;2021-01-06;1;0;10;0
11;2021-01-07;8;0;18;0
11;2021-01-08;12;0;30;0
11;2021-01-09;15;0;45;0
11;2021-01-10;10;0;55;0
11;2021-01-11;16;0;71;0
11;2021-01-12;47;0;118;0
11;2021-01-13;35;0;153;0
11;2021-01-14;41;0;194;0
11;2021-01-15;43;0;237;0
11;2021-01-16;8;0;245;0
11;2021-01-17;10;0;255;0
11;2021-01-18;13;0;268;0
11;2021-01-19;38;0;306;0
11;2021-01-20;54;0;360;0
11;2021-01-21;30;0;390;0
11;2021-01-22;29;0;419;0
11;2021-01-23;5;0;424;0
11;2021-01-24;7;0;431;0
11;2021-01-25;14;1;445;1
11;2021-01-26;31;7;476;8
11;2021-01-27;49;1;525;9
11;2021-01-28;52;10;577;19
11;2021-01-29;18;12;595;31
11;2021-01-30;4;0;599;31
11;2021-01-31;4;0;603;31
11;2021-02-01;28;18;631;49
11;2021-02-02;26;44;657;93
11;2021-02-03;32;36;689;129
11;2021-02-04;28;49;717;178
11;2021-02-05;9;32;726;210
11;2021-02-06;11;4;737;214
11;2021-02-07;9;5;746;219
11;2021-02-08;15;11;761;230
11;2021-02-09;13;28;774;258
11;2021-02-10;20;38;794;296
11;2021-02-11;30;31;824;327
11;2021-02-12;16;26;840;353
11;2021-02-13;6;4;846;357
11;2021-02-14;4;1;850;358
11;2021-02-15;18;7;868;365
11;2021-02-16;19;25;887;390
11;2021-02-17;28;34;915;424
11;2021-02-18;25;43;940;467
11;2021-02-19;21;23;961;490
11;2021-02-20;9;2;970;492
11;2021-02-21;1;5;971;497
11;2021-02-22;8;16;979;513
11;2021-02-23;9;23;988;536
11;2021-02-24;22;34;1010;570
11;2021-02-25;78;22;1088;592
11;2021-02-26;105;22;1193;614
11;2021-02-27;93;8;1286;622
11;2021-02-28;33;4;1319;626
11;2021-03-01;63;25;1382;651
11;2021-03-02;108;23;1490;674
11;2021-03-03;106;22;1596;696
11;2021-03-04;228;25;1824;721
11;2021-03-05;179;21;2003;742
11;2021-03-06;244;14;2247;756
11;2021-03-07;74;4;2321;760
11;2021-03-08;68;14;2389;774
11;2021-03-09;107;16;2496;790
11;2021-03-10;171;24;2667;814
11;2021-03-11;202;25;2869;839
11;2021-03-12;226;15;3095;854
11;2021-03-13;188;7;3283;861
11;2021-03-14;67;3;3350;864
11;2021-03-15;82;16;3432;880
11;2021-03-16;54;8;3486;888
11;2021-03-17;56;19;3542;907
11;2021-03-18;75;17;3617;924
11;2021-03-19;144;9;3761;933
11;2021-03-20;84;13;3845;946
11;2021-03-21;38;1;3883;947
11;2021-03-22;62;15;3945;962
11;2021-03-23;189;14;4134;976
11;2021-03-24;174;13;4308;989
11;2021-03-25;240;19;4548;1008
11;2021-03-26;248;24;4796;1032
11;2021-03-27;146;8;4942;1040
11;2021-03-28;31;1;4973;1041
11;2021-03-29;92;12;5065;1053
11;2021-03-30;194;15;5259;1068
11;2021-03-31;161;16;5420;1084
11;2021-04-01;208;23;5628;1107
12;2020-12-28;0;0;0;0
12;2020-12-29;0;0;0;0
12;2020-12-30;0;0;0;0
12;2020-12-31;0;0;0;0
12;2021-01-01;0;0;0;0
12;2021-01-02;0;0;0;0
12;2021-01-03;0;0;0;0
12;2021-01-04;0;0;0;0
12;2021-01-05;0;0;0;0
12;2021-01-06;0;0;0;0
12;2021-01-07;9;0;9;0
12;2021-01-08;8;0;17;0
12;2021-01-09;0;0;17;0
12;2021-01-10;0;0;17;0
12;2021-01-11;8;0;25;0
12;2021-01-12;13;0;38;0
12;2021-01-13;28;0;66;0
12;2021-01-14;41;0;107;0
12;2021-01-15;23;0;130;0
12;2021-01-16;5;1;135;1
12;2021-01-17;0;0;135;1
12;2021-01-18;28;0;163;1
12;2021-01-19;37;0;200;1
12;2021-01-20;49;0;249;1
12;2021-01-21;33;0;282;1
12;2021-01-22;39;0;321;1
12;2021-01-23;20;0;341;1
12;2021-01-24;0;0;341;1
12;2021-01-25;20;0;361;1
12;2021-01-26;24;0;385;1
12;2021-01-27;72;0;457;1
12;2021-01-28;85;9;542;10
12;2021-01-29;53;6;595;16
12;2021-01-30;17;1;612;17
12;2021-01-31;0;0;612;17
12;2021-02-01;13;9;625;26
12;2021-02-02;23;16;648;42
12;2021-02-03;11;21;659;63
12;2021-02-04;13;33;672;96
12;2021-02-05;24;16;696;112
12;2021-02-06;7;3;703;115
12;2021-02-07;3;0;706;115
12;2021-02-08;7;16;713;131
12;2021-02-09;17;33;730;164
12;2021-02-10;15;34;745;198
12;2021-02-11;37;14;782;212
12;2021-02-12;42;15;824;227
12;2021-02-13;12;7;836;234
12;2021-02-14;0;0;836;234
12;2021-02-15;6;14;842;248
12;2021-02-16;9;20;851;268
12;2021-02-17;21;61;872;329
12;2021-02-18;29;63;901;392
12;2021-02-19;32;47;933;439
12;2021-02-20;7;22;940;461
12;2021-02-21;0;0;940;461
12;2021-02-22;10;18;950;479
12;2021-02-23;8;23;958;502
12;2021-02-24;5;26;963;528
12;2021-02-25;32;36;995;564
12;2021-02-26;67;34;1062;598
12;2021-02-27;62;16;1124;614
12;2021-02-28;4;0;1128;614
12;2021-03-01;11;12;1139;626
12;2021-03-02;65;12;1204;638
12;2021-03-03;70;11;1274;649
12;2021-03-04;80;17;1354;666
12;2021-03-05;77;19;1431;685
12;2021-03-06;128;1;1559;686
12;2021-03-07;14;0;1573;686
12;2021-03-08;36;8;1609;694
12;2021-03-09;96;6;1705;700
12;2021-03-10;95;31;1800;731
12;2021-03-11;108;33;1908;764
12;2021-03-12;162;30;2070;794
12;2021-03-13;137;6;2207;800
12;2021-03-14;8;0;2215;800
12;2021-03-15;34;2;2249;802
12;2021-03-16;44;9;2293;811
12;2021-03-17;66;7;2359;818
12;2021-03-18;61;12;2420;830
12;2021-03-19;87;12;2507;842
12;2021-03-20;65;4;2572;846
12;2021-03-21;43;0;2615;846
12;2021-03-22;43;9;2658;855
12;2021-03-23;120;6;2778;861
12;2021-03-24;119;10;2897;871
12;2021-03-25;180;8;3077;879
12;2021-03-26;176;11;3253;890
12;2021-03-27;121;4;3374;894
12;2021-03-28;14;0;3388;894
12;2021-03-29;102;4;3490;898
12;2021-03-30;180;2;3670;900
12;2021-03-31;162;1;3832;901
12;2021-04-01;238;3;4070;904
13;2020-12-28;0;0;0;0
13;2020-12-29;0;0;0;0
13;2020-12-30;0;0;0;0
13;2020-12-31;0;0;0;0
13;2021-01-01;0;0;0;0
13;2021-01-02;0;0;0;0
13;2021-01-03;0;0;0;0
13;2021-01-04;0;0;0;0
13;2021-01-05;15;0;15;0
13;2021-01-06;19;0;34;0
13;2021-01-07;35;0;69;0
13;2021-01-08;26;0;95;0
13;2021-01-09;0;0;95;0
13;2021-01-10;0;0;95;0
13;2021-01-11;80;0;175;0
13;2021-01-12;107;0;282;0
13;2021-01-13;159;0;441;0
13;2021-01-14;208;0;649;0
13;2021-01-15;185;0;834;0
13;2021-01-16;62;1;896;1
13;2021-01-17;6;0;902;1
13;2021-01-18;207;0;1109;1
13;2021-01-19;451;0;1560;1
13;2021-01-20;457;0;2017;1
13;2021-01-21;386;0;2403;1
13;2021-01-22;324;0;2727;1
13;2021-01-23;70;0;2797;1
13;2021-01-24;38;0;2835;1
13;2021-01-25;160;1;2995;2
13;2021-01-26;213;16;3208;18
13;2021-01-27;281;21;3489;39
13;2021-01-28;244;32;3733;71
13;2021-01-29;179;19;3912;90
13;2021-01-30;54;0;3966;90
13;2021-01-31;12;0;3978;90
13;2021-02-01;118;48;4096;138
13;2021-02-02;146;90;4242;228
13;2021-02-03;119;88;4361;316
13;2021-02-04;132;150;4493;466
13;2021-02-05;212;202;4705;668
13;2021-02-06;43;49;4748;717
13;2021-02-07;15;0;4763;717
13;2021-02-08;109;160;4872;877
13;2021-02-09;233;360;5105;1237
13;2021-02-10;252;367;5357;1604
13;2021-02-11;327;316;5684;1920
13;2021-02-12;206;252;5890;2172
13;2021-02-13;35;43;5925;2215
13;2021-02-14;9;16;5934;2231
13;2021-02-15;68;160;6002;2391
13;2021-02-16;117;206;6119;2597
13;2021-02-17;139;229;6258;2826
13;2021-02-18;152;194;6410;3020
13;2021-02-19;150;175;6560;3195
13;2021-02-20;19;47;6579;3242
13;2021-02-21;3;16;6582;3258
13;2021-02-22;84;125;6666;3383
13;2021-02-23;118;175;6784;3558
13;2021-02-24;165;204;6949;3762
13;2021-02-25;456;172;7405;3934
13;2021-02-26;587;127;7992;4061
13;2021-02-27;218;43;8210;4104
13;2021-02-28;32;3;8242;4107
13;2021-03-01;234;119;8476;4226
13;2021-03-02;520;218;8996;4444
13;2021-03-03;638;251;9634;4695
13;2021-03-04;813;286;10447;4981
13;2021-03-05;719;172;11166;5153
13;2021-03-06;779;37;11945;5190
13;2021-03-07;493;6;12438;5196
13;2021-03-08;465;101;12903;5297
13;2021-03-09;679;172;13582;5469
13;2021-03-10;894;125;14476;5594
13;2021-03-11;1277;127;15753;5721
13;2021-03-12;1313;128;17066;5849
13;2021-03-13;1048;27;18114;5876
13;2021-03-14;258;4;18372;5880
13;2021-03-15;782;84;19154;5964
13;2021-03-16;544;122;19698;6086
13;2021-03-17;507;137;20205;6223
13;2021-03-18;574;150;20779;6373
13;2021-03-19;823;99;21602;6472
13;2021-03-20;567;22;22169;6494
13;2021-03-21;86;1;22255;6495
13;2021-03-22;914;85;23169;6580
13;2021-03-23;1230;99;24399;6679
13;2021-03-24;1270;145;25669;6824
13;2021-03-25;1539;152;27208;6976
13;2021-03-26;1521;102;28729;7078
13;2021-03-27;708;24;29437;7102
13;2021-03-28;110;6;29547;7108
13;2021-03-29;980;96;30527;7204
13;2021-03-30;1615;158;32142;7362
13;2021-03-31;1350;223;33492;7585
13;2021-04-01;1513;230;35005;7815
14;2020-12-28;0;0;0;0
14;2020-12-29;0;0;0;0
14;2020-12-30;0;0;0;0
14;2020-12-31;0;0;0;0
14;2021-01-01;0;0;0;0
14;2021-01-02;0;0;0;0
14;2021-01-03;0;0;0;0
14;2021-01-04;0;0;0;0
14;2021-01-05;3;0;3;0
14;2021-01-06;37;0;40;0
14;2021-01-07;55;0;95;0
14;2021-01-08;91;0;186;0
14;2021-01-09;16;0;202;0
14;2021-01-10;5;0;207;0
14;2021-01-11;75;0;282;0
14;2021-01-12;94;0;376;0
14;2021-01-13;105;0;481;0
14;2021-01-14;154;0;635;0
14;2021-01-15;140;0;775;0
14;2021-01-16;26;0;801;0
14;2021-01-17;11;0;812;0
14;2021-01-18;46;0;858;0
14;2021-01-19;56;0;914;0
14;2021-01-20;81;0;995;0
14;2021-01-21;87;0;1082;0
14;2021-01-22;75;0;1157;0
14;2021-01-23;15;0;1172;0
14;2021-01-24;1;0;1173;0
14;2021-01-25;31;1;1204;1
14;2021-01-26;41;7;1245;8
14;2021-01-27;35;12;1280;20
14;2021-01-28;34;15;1314;35
14;2021-01-29;39;27;1353;62
14;2021-01-30;9;2;1362;64
14;2021-01-31;6;1;1368;65
14;2021-02-01;33;28;1401;93
14;2021-02-02;32;40;1433;133
14;2021-02-03;27;71;1460;204
14;2021-02-04;83;109;1543;313
14;2021-02-05;79;101;1622;414
14;2021-02-06;13;21;1635;435
14;2021-02-07;6;6;1641;441
14;2021-02-08;39;61;1680;502
14;2021-02-09;34;77;1714;579
14;2021-02-10;40;108;1754;687
14;2021-02-11;63;100;1817;787
14;2021-02-12;57;75;1874;862
14;2021-02-13;15;15;1889;877
14;2021-02-14;2;4;1891;881
14;2021-02-15;21;59;1912;940
14;2021-02-16;47;63;1959;1003
14;2021-02-17;27;55;1986;1058
14;2021-02-18;70;37;2056;1095
14;2021-02-19;32;32;2088;1127
14;2021-02-20;4;10;2092;1137
14;2021-02-21;0;3;2092;1140
14;2021-02-22;40;40;2132;1180
14;2021-02-23;60;43;2192;1223
14;2021-02-24;108;42;2300;1265
14;2021-02-25;469;74;2769;1339
14;2021-02-26;506;80;3275;1419
14;2021-02-27;220;17;3495;1436
14;2021-02-28;12;2;3507;1438
14;2021-03-01;69;28;3576;1466
14;2021-03-02;272;23;3848;1489
14;2021-03-03;260;44;4108;1533
14;2021-03-04;463;59;4571;1592
14;2021-03-05;602;43;5173;1635
14;2021-03-06;362;9;5535;1644
14;2021-03-07;63;5;5598;1649
14;2021-03-08;169;37;5767;1686
14;2021-03-09;289;30;6056;1716
14;2021-03-10;291;24;6347;1740
14;2021-03-11;536;21;6883;1761
14;2021-03-12;813;11;7696;1772
14;2021-03-13;505;6;8201;1778
14;2021-03-14;6;2;8207;1780
14;2021-03-15;257;0;8464;1780
14;2021-03-16;109;28;8573;1808
14;2021-03-17;99;6;8672;1814
14;2021-03-18;105;30;8777;1844
14;2021-03-19;347;12;9124;1856
14;2021-03-20;230;0;9354;1856
14;2021-03-21;30;0;9384;1856
14;2021-03-22;228;39;9612;1895
14;2021-03-23;286;38;9898;1933
14;2021-03-24;360;3;10258;1936
14;2021-03-25;508;8;10766;1944
14;2021-03-26;673;25;11439;1969
14;2021-03-27;198;2;11637;1971
14;2021-03-28;1;0;11638;1971
14;2021-03-29;191;21;11829;1992
14;2021-03-30;289;13;12118;2005
14;2021-03-31;255;29;12373;2034
14;2021-04-01;434;64;12807;2098
15;2020-12-28;0;0;0;0
15;2020-12-29;0;0;0;0
15;2020-12-30;0;0;0;0
15;2020-12-31;0;0;0;0
15;2021-01-01;0;0;0;0
15;2021-01-02;0;0;0;0
15;2021-01-03;0;0;0;0
15;2021-01-04;0;0;0;0
15;2021-01-05;0;0;0;0
15;2021-01-06;0;0;0;0
15;2021-01-07;3;0;3;0
15;2021-01-08;3;0;6;0
15;2021-01-09;0;0;6;0
15;2021-01-10;0;0;6;0
15;2021-01-11;11;0;17;0
15;2021-01-12;15;0;32;0
15;2021-01-13;37;0;69;0
15;2021-01-14;25;0;94;0
15;2021-01-15;22;0;116;0
15;2021-01-16;4;0;120;0
15;2021-01-17;0;0;120;0
15;2021-01-18;26;0;146;0
15;2021-01-19;26;0;172;0
15;2021-01-20;43;0;215;0
15;2021-01-21;36;0;251;0
15;2021-01-22;35;0;286;0
15;2021-01-23;20;0;306;0
15;2021-01-24;0;0;306;0
15;2021-01-25;23;0;329;0
15;2021-01-26;12;0;341;0
15;2021-01-27;32;0;373;0
15;2021-01-28;32;1;405;1
15;2021-01-29;24;2;429;3
15;2021-01-30;20;0;449;3
15;2021-01-31;0;0;449;3
15;2021-02-01;20;9;469;12
15;2021-02-02;16;14;485;26
15;2021-02-03;12;26;497;52
15;2021-02-04;34;23;531;75
15;2021-02-05;22;11;553;86
15;2021-02-06;5;4;558;90
15;2021-02-07;0;0;558;90
15;2021-02-08;27;15;585;105
15;2021-02-09;10;14;595;119
15;2021-02-10;25;17;620;136
15;2021-02-11;8;11;628;147
15;2021-02-12;8;21;636;168
15;2021-02-13;6;3;642;171
15;2021-02-14;0;0;642;171
15;2021-02-15;8;30;650;201
15;2021-02-16;8;22;658;223
15;2021-02-17;11;37;669;260
15;2021-02-18;4;42;673;302
15;2021-02-19;3;22;676;324
15;2021-02-20;2;13;678;337
15;2021-02-21;0;0;678;337
15;2021-02-22;2;30;680;367
15;2021-02-23;17;21;697;388
15;2021-02-24;3;20;700;408
15;2021-02-25;66;33;766;441
15;2021-02-26;66;20;832;461
15;2021-02-27;45;13;877;474
15;2021-02-28;0;0;877;474
15;2021-03-01;22;22;899;496
15;2021-03-02;71;18;970;514
15;2021-03-03;79;1;1049;515
15;2021-03-04;79;19;1128;534
15;2021-03-05;100;10;1228;544
15;2021-03-06;120;6;1348;550
15;2021-03-07;3;0;1351;550
15;2021-03-08;7;13;1358;563
15;2021-03-09;54;16;1412;579
15;2021-03-10;80;18;1492;597
15;2021-03-11;83;5;1575;602
15;2021-03-12;111;2;1686;604
15;2021-03-13;72;0;1758;604
15;2021-03-14;3;0;1761;604
15;2021-03-15;32;3;1793;607
15;2021-03-16;12;3;1805;610
15;2021-03-17;6;5;1811;615
15;2021-03-18;11;11;1822;626
15;2021-03-19;36;3;1858;629
15;2021-03-20;19;0;1877;629
15;2021-03-21;1;0;1878;629
15;2021-03-22;31;4;1909;633
15;2021-03-23;65;2;1974;635
15;2021-03-24;94;7;2068;642
15;2021-03-25;142;4;2210;646
15;2021-03-26;96;12;2306;658
15;2021-03-27;29;0;2335;658
15;2021-03-28;2;0;2337;658
15;2021-03-29;78;0;2415;658
15;2021-03-30;113;31;2528;689
15;2021-03-31;90;0;2618;689
15;2021-04-01;105;7;2723;696
16;2020-12-28;0;0;0;0
16;2020-12-29;0;0;0;0
16;2020-12-30;0;0;0;0
16;2020-12-31;0;0;0;0
16;2021-01-01;0;0;0;0
16;2021-01-02;0;0;0;0
16;2021-01-03;0;0;0;0
16;2021-01-04;0;0;0;0
16;2021-01-05;0;0;0;0
16;2021-01-06;0;0;0;0
16;2021-01-07;17;0;17;0
16;2021-01-08;36;0;53;0
16;2021-01-09;0;0;53;0
16;2021-01-10;0;0;53;0
16;2021-01-11;38;0;91;0
16;2021-01-12;38;0;129;0
16;2021-01-13;40;0;169;0
16;2021-01-14;53;0;222;0
16;2021-01-15;45;0;267;0
16;2021-01-16;0;0;267;0
16;2021-01-17;0;0;267;0
16;2021-01-18;24;0;291;0
16;2021-01-19;54;0;345;0
16;2021-01-20;51;0;396;0
16;2021-01-21;56;0;452;0
16;2021-01-22;58;0;510;0
16;2021-01-23;9;0;519;0
16;2021-01-24;0;0;519;0
16;2021-01-25;24;0;543;0
16;2021-01-26;35;0;578;0
16;2021-01-27;46;1;624;1
16;2021-01-28;63;9;687;10
16;2021-01-29;30;23;717;33
16;2021-01-30;0;0;717;33
16;2021-01-31;0;0;717;33
16;2021-02-01;25;14;742;47
16;2021-02-02;16;17;758;64
16;2021-02-03;19;27;777;91
16;2021-02-04;19;39;796;130
16;2021-02-05;15;32;811;162
16;2021-02-06;0;0;811;162
16;2021-02-07;1;0;812;162
16;2021-02-08;24;19;836;181
16;2021-02-09;30;25;866;206
16;2021-02-10;34;39;900;245
16;2021-02-11;44;50;944;295
16;2021-02-12;48;45;992;340
16;2021-02-13;1;1;993;341
16;2021-02-14;0;0;993;341
16;2021-02-15;24;32;1017;373
16;2021-02-16;12;54;1029;427
16;2021-02-17;23;58;1052;485
16;2021-02-18;21;65;1073;550
16;2021-02-19;28;49;1101;599
16;2021-02-20;0;0;1101;599
16;2021-02-21;0;0;1101;599
16;2021-02-22;4;28;1105;627
16;2021-02-23;17;18;1122;645
16;2021-02-24;27;25;1149;670
16;2021-02-25;55;18;1204;688
16;2021-02-26;143;14;1347;702
16;2021-02-27;119;0;1466;702
16;2021-02-28;1;0;1467;702
16;2021-03-01;50;8;1517;710
16;2021-03-02;57;24;1574;734
16;2021-03-03;103;21;1677;755
16;2021-03-04;116;26;1793;781
16;2021-03-05;205;29;1998;810
16;2021-03-06;158;0;2156;810
16;2021-03-07;9;0;2165;810
16;2021-03-08;75;16;2240;826
16;2021-03-09;75;30;2315;856
16;2021-03-10;104;42;2419;898
16;2021-03-11;243;32;2662;930
16;2021-03-12;209;29;2871;959
16;2021-03-13;166;0;3037;959
16;2021-03-14;0;0;3037;959
16;2021-03-15;69;4;3106;963
16;2021-03-16;52;16;3158;979
16;2021-03-17;35;26;3193;1005
16;2021-03-18;53;9;3246;1014
16;2021-03-19;93;10;3339;1024
16;2021-03-20;60;0;3399;1024
16;2021-03-21;0;0;3399;1024
16;2021-03-22;71;6;3470;1030
16;2021-03-23;109;7;3579;1037
16;2021-03-24;127;14;3706;1051
16;2021-03-25;238;12;3944;1063
16;2021-03-26;256;5;4200;1068
16;2021-03-27;66;0;4266;1068
16;2021-03-28;0;0;4266;1068
16;2021-03-29;98;4;4364;1072
16;2021-03-30;164;7;4528;1079
16;2021-03-31;195;13;4723;1092
16;2021-04-01;201;17;4924;1109
17;2020-12-28;0;0;0;0
17;2020-12-29;0;0;0;0
17;2020-12-30;0;0;0;0
17;2020-12-31;0;0;0;0
17;2021-01-01;0;0;0;0
17;2021-01-02;0;0;0;0
17;2021-01-03;0;0;0;0
17;2021-01-04;5;0;5;0
17;2021-01-05;6;0;11;0
17;2021-01-06;15;0;26;0
17;2021-01-07;49;0;75;0
17;2021-01-08;48;0;123;0
17;2021-01-09;0;0;123;0
17;2021-01-10;0;0;123;0
17;2021-01-11;46;0;169;0
17;2021-01-12;62;0;231;0
17;2021-01-13;67;0;298;0
17;2021-01-14;75;0;373;0
17;2021-01-15;77;0;450;0
17;2021-01-16;20;0;470;0
17;2021-01-17;1;0;471;0
17;2021-01-18;63;0;534;0
17;2021-01-19;95;0;629;0
17;2021-01-20;105;0;734;0
17;2021-01-21;131;0;865;0
17;2021-01-22;67;0;932;0
17;2021-01-23;25;0;957;0
17;2021-01-24;1;0;958;0
17;2021-01-25;47;0;1005;0
17;2021-01-26;57;0;1062;0
17;2021-01-27;39;6;1101;6
17;2021-01-28;65;17;1166;23
17;2021-01-29;85;15;1251;38
17;2021-01-30;19;0;1270;38
17;2021-01-31;2;0;1272;38
17;2021-02-01;36;24;1308;62
17;2021-02-02;32;62;1340;124
17;2021-02-03;45;44;1385;168
17;2021-02-04;30;74;1415;242
17;2021-02-05;22;72;1437;314
17;2021-02-06;10;9;1447;323
17;2021-02-07;2;0;1449;323
17;2021-02-08;32;43;1481;366
17;2021-02-09;52;67;1533;433
17;2021-02-10;34;83;1567;516
17;2021-02-11;58;94;1625;610
17;2021-02-12;26;77;1651;687
17;2021-02-13;3;15;1654;702
17;2021-02-14;0;0;1654;702
17;2021-02-15;15;58;1669;760
17;2021-02-16;25;92;1694;852
17;2021-02-17;61;47;1755;899
17;2021-02-18;40;71;1795;970
17;2021-02-19;47;87;1842;1057
17;2021-02-20;2;10;1844;1067
17;2021-02-21;1;0;1845;1067
17;2021-02-22;30;44;1875;1111
17;2021-02-23;48;42;1923;1153
17;2021-02-24;59;32;1982;1185
17;2021-02-25;174;47;2156;1232
17;2021-02-26;293;37;2449;1269
17;2021-02-27;168;11;2617;1280
17;2021-02-28;2;0;2619;1280
17;2021-03-01;92;41;2711;1321
17;2021-03-02;206;30;2917;1351
17;2021-03-03;321;51;3238;1402
17;2021-03-04;478;37;3716;1439
17;2021-03-05;500;30;4216;1469
17;2021-03-06;337;0;4553;1469
17;2021-03-07;30;0;4583;1469
17;2021-03-08;98;44;4681;1513
17;2021-03-09;249;13;4930;1526
17;2021-03-10;281;12;5211;1538
17;2021-03-11;428;50;5639;1588
17;2021-03-12;503;21;6142;1609
17;2021-03-13;250;0;6392;1609
17;2021-03-14;2;0;6394;1609
17;2021-03-15;111;37;6505;1646
17;2021-03-16;39;17;6544;1663
17;2021-03-17;68;19;6612;1682
17;2021-03-18;78;42;6690;1724
17;2021-03-19;194;17;6884;1741
17;2021-03-20;139;1;7023;1742
17;2021-03-21;5;0;7028;1742
17;2021-03-22;136;17;7164;1759
17;2021-03-23;275;22;7439;1781
17;2021-03-24;295;30;7734;1811
17;2021-03-25;439;32;8173;1843
17;2021-03-26;448;19;8621;1862
17;2021-03-27;199;0;8820;1862
17;2021-03-28;16;0;8836;1862
17;2021-03-29;183;28;9019;1890
17;2021-03-30;235;36;9254;1926
17;2021-03-31;289;19;9543;1945
17;2021-04-01;373;46;9916;1991
18;2020-12-28;0;0;0;0
18;2020-12-29;0;0;0;0
18;2020-12-30;0;0;0;0
18;2020-12-31;0;0;0;0
18;2021-01-01;0;0;0;0
18;2021-01-02;0;0;0;0
18;2021-01-03;0;0;0;0
18;2021-01-04;0;0;0;0
18;2021-01-05;0;0;0;0
18;2021-01-06;0;0;0;0
18;2021-01-07;5;0;5;0
18;2021-01-08;3;0;8;0
18;2021-01-09;32;0;40;0
18;2021-01-10;16;0;56;0
18;2021-01-11;26;0;82;0
18;2021-01-12;29;0;111;0
18;2021-01-13;22;0;133;0
18;2021-01-14;20;0;153;0
18;2021-01-15;35;0;188;0
18;2021-01-16;18;0;206;0
18;2021-01-17;0;0;206;0
18;2021-01-18;13;0;219;0
18;2021-01-19;53;0;272;0
18;2021-01-20;54;0;326;0
18;2021-01-21;47;0;373;0
18;2021-01-22;42;0;415;0
18;2021-01-23;8;0;423;0
18;2021-01-24;0;0;423;0
18;2021-01-25;20;0;443;0
18;2021-01-26;34;0;477;0
18;2021-01-27;16;0;493;0
18;2021-01-28;27;6;520;6
18;2021-01-29;28;3;548;9
18;2021-01-30;12;26;560;35
18;2021-01-31;0;10;560;45
18;2021-02-01;16;15;576;60
18;2021-02-02;16;14;592;74
18;2021-02-03;19;14;611;88
18;2021-02-04;25;18;636;106
18;2021-02-05;26;22;662;128
18;2021-02-06;13;9;675;137
18;2021-02-07;0;0;675;137
18;2021-02-08;18;25;693;162
18;2021-02-09;27;34;720;196
18;2021-02-10;49;45;769;241
18;2021-02-11;53;15;822;256
18;2021-02-12;30;27;852;283
18;2021-02-13;17;14;869;297
18;2021-02-14;20;0;889;297
18;2021-02-15;17;25;906;322
18;2021-02-16;16;32;922;354
18;2021-02-17;25;25;947;379
18;2021-02-18;21;22;968;401
18;2021-02-19;33;20;1001;421
18;2021-02-20;20;9;1021;430
18;2021-02-21;12;0;1033;430
18;2021-02-22;10;25;1043;455
18;2021-02-23;9;20;1052;475
18;2021-02-24;16;7;1068;482
18;2021-02-25;38;32;1106;514
18;2021-02-26;95;26;1201;540
18;2021-02-27;111;10;1312;550
18;2021-02-28;2;0;1314;550
18;2021-03-01;63;24;1377;574
18;2021-03-02;44;24;1421;598
18;2021-03-03;79;28;1500;626
18;2021-03-04;88;34;1588;660
18;2021-03-05;104;23;1692;683
18;2021-03-06;179;12;1871;695
18;2021-03-07;1;0;1872;695
18;2021-03-08;53;24;1925;719
18;2021-03-09;55;20;1980;739
18;2021-03-10;58;32;2038;771
18;2021-03-11;83;28;2121;799
18;2021-03-12;126;17;2247;816
18;2021-03-13;166;15;2413;831
18;2021-03-14;22;9;2435;840
18;2021-03-15;63;15;2498;855
18;2021-03-16;28;14;2526;869
18;2021-03-17;19;29;2545;898
18;2021-03-18;41;16;2586;914
18;2021-03-19;65;14;2651;928
18;2021-03-20;112;10;2763;938
18;2021-03-21;16;11;2779;949
18;2021-03-22;81;15;2860;964
18;2021-03-23;61;14;2921;978
18;2021-03-24;152;15;3073;993
18;2021-03-25;124;15;3197;1008
18;2021-03-26;194;12;3391;1020
18;2021-03-27;157;17;3548;1037
18;2021-03-28;15;0;3563;1037
18;2021-03-29;108;19;3671;1056
18;2021-03-30;95;16;3766;1072
18;2021-03-31;155;10;3921;1082
18;2021-04-01;147;18;4068;1100
19;2020-12-28;0;0;0;0
19;2020-12-29;0;0;0;0
19;2020-12-30;0;0;0;0
19;2020-12-31;0;0;0;0
19;2021-01-01;0;0;0;0
19;2021-01-02;0;0;0;0
19;2021-01-03;0;0;0;0
19;2021-01-04;0;0;0;0
19;2021-01-05;0;0;0;0
19;2021-01-06;0;0;0;0
19;2021-01-07;21;0;21;0
19;2021-01-08;15;0;36;0
19;2021-01-09;0;0;36;0
19;2021-01-10;0;0;36;0
19;2021-01-11;5;0;41;0
19;2021-01-12;21;0;62;0
19;2021-01-13;38;0;100;0
19;2021-01-14;39;0;139;0
19;2021-01-15;21;0;160;0
19;2021-01-16;0;0;160;0
19;2021-01-17;0;0;160;0
19;2021-01-18;21;0;181;0
19;2021-01-19;26;0;207;0
19;2021-01-20;35;0;242;0
19;2021-01-21;35;0;277;0
19;2021-01-22;71;0;348;0
19;2021-01-23;8;0;356;0
19;2021-01-24;0;0;356;0
19;2021-01-25;8;0;364;0
19;2021-01-26;23;0;387;0
19;2021-01-27;21;1;408;1
19;2021-01-28;16;6;424;7
19;2021-01-29;27;4;451;11
19;2021-01-30;5;1;456;12
19;2021-01-31;1;0;457;12
19;2021-02-01;2;13;459;25
19;2021-02-02;29;21;488;46
19;2021-02-03;21;29;509;75
19;2021-02-04;20;21;529;96
19;2021-02-05;15;8;544;104
19;2021-02-06;9;0;553;104
19;2021-02-07;1;0;554;104
19;2021-02-08;13;11;567;115
19;2021-02-09;41;13;608;128
19;2021-02-10;44;19;652;147
19;2021-02-11;31;33;683;180
19;2021-02-12;70;65;753;245
19;2021-02-13;11;8;764;253
19;2021-02-14;2;0;766;253
19;2021-02-15;12;15;778;268
19;2021-02-16;27;20;805;288
19;2021-02-17;21;29;826;317
19;2021-02-18;18;29;844;346
19;2021-02-19;27;16;871;362
19;2021-02-20;4;2;875;364
19;2021-02-21;2;2;877;366
19;2021-02-22;15;3;892;369
19;2021-02-23;12;20;904;389
19;2021-02-24;12;11;916;400
19;2021-02-25;110;29;1026;429
19;2021-02-26;116;14;1142;443
19;2021-02-27;97;4;1239;447
19;2021-02-28;2;2;1241;449
19;2021-03-01;30;5;1271;454
19;2021-03-02;60;19;1331;473
19;2021-03-03;105;28;1436;501
19;2021-03-04;167;28;1603;529
19;2021-03-05;135;48;1738;577
19;2021-03-06;188;9;1926;586
19;2021-03-07;40;1;1966;587
19;2021-03-08;64;14;2030;601
19;2021-03-09;72;32;2102;633
19;2021-03-10;137;17;2239;650
19;2021-03-11;125;36;2364;686
19;2021-03-12;150;26;2514;712
19;2021-03-13;196;6;2710;718
19;2021-03-14;16;1;2726;719
19;2021-03-15;66;9;2792;728
19;2021-03-16;42;19;2834;747
19;2021-03-17;51;25;2885;772
19;2021-03-18;42;17;2927;789
19;2021-03-19;94;25;3021;814
19;2021-03-20;92;3;3113;817
19;2021-03-21;20;1;3133;818
19;2021-03-22;30;11;3163;829
19;2021-03-23;129;11;3292;840
19;2021-03-24;143;17;3435;857
19;2021-03-25;131;28;3566;885
19;2021-03-26;146;14;3712;899
19;2021-03-27;87;12;3799;911
19;2021-03-28;6;2;3805;913
19;2021-03-29;53;5;3858;918
19;2021-03-30;89;10;3947;928
19;2021-03-31;148;31;4095;959
19;2021-04-01;113;21;4208;980
21;2020-12-28;0;0;0;0
21;2020-12-29;0;0;0;0
21;2020-12-30;0;0;0;0
21;2020-12-31;0;0;0;0
21;2021-01-01;0;0;0;0
21;2021-01-02;0;0;0;0
21;2021-01-03;0;0;0;0
21;2021-01-04;2;0;2;0
21;2021-01-05;47;0;49;0
21;2021-01-06;45;0;94;0
21;2021-01-07;34;0;128;0
21;2021-01-08;55;0;183;0
21;2021-01-09;17;0;200;0
21;2021-01-10;0;0;200;0
21;2021-01-11;58;0;258;0
21;2021-01-12;78;0;336;0
21;2021-01-13;63;0;399;0
21;2021-01-14;102;0;501;0
21;2021-01-15;65;0;566;0
21;2021-01-16;13;3;579;3
21;2021-01-17;0;0;579;3
21;2021-01-18;99;0;678;3
21;2021-01-19;97;0;775;3
21;2021-01-20;94;0;869;3
21;2021-01-21;89;0;958;3
21;2021-01-22;96;1;1054;4
21;2021-01-23;26;0;1080;4
21;2021-01-24;2;0;1082;4
21;2021-01-25;56;2;1138;6
21;2021-01-26;57;46;1195;52
21;2021-01-27;94;41;1289;93
21;2021-01-28;68;38;1357;131
21;2021-01-29;51;40;1408;171
21;2021-01-30;17;4;1425;175
21;2021-01-31;5;0;1430;175
21;2021-02-01;20;43;1450;218
21;2021-02-02;21;60;1471;278
21;2021-02-03;20;39;1491;317
21;2021-02-04;26;80;1517;397
21;2021-02-05;19;52;1536;449
21;2021-02-06;11;20;1547;469
21;2021-02-07;0;0;1547;469
21;2021-02-08;19;52;1566;521
21;2021-02-09;17;51;1583;572
21;2021-02-10;20;54;1603;626
21;2021-02-11;30;76;1633;702
21;2021-02-12;15;48;1648;750
21;2021-02-13;21;18;1669;768
21;2021-02-14;9;2;1678;770
21;2021-02-15;3;71;1681;841
21;2021-02-16;9;87;1690;928
21;2021-02-17;24;110;1714;1038
21;2021-02-18;18;90;1732;1128
21;2021-02-19;10;62;1742;1190
21;2021-02-20;8;24;1750;1214
21;2021-02-21;0;0;1750;1214
21;2021-02-22;0;31;1750;1245
21;2021-02-23;5;29;1755;1274
21;2021-02-24;35;29;1790;1303
21;2021-02-25;274;37;2064;1340
21;2021-02-26;343;25;2407;1365
21;2021-02-27;231;9;2638;1374
21;2021-02-28;13;5;2651;1379
21;2021-03-01;94;20;2745;1399
21;2021-03-02;163;20;2908;1419
21;2021-03-03;221;21;3129;1440
21;2021-03-04;325;31;3454;1471
21;2021-03-05;458;19;3912;1490
21;2021-03-06;393;13;4305;1503
21;2021-03-07;0;0;4305;1503
21;2021-03-08;106;15;4411;1518
21;2021-03-09;193;21;4604;1539
21;2021-03-10;179;35;4783;1574
21;2021-03-11;264;28;5047;1602
21;2021-03-12;493;17;5540;1619
21;2021-03-13;399;9;5939;1628
21;2021-03-14;1;0;5940;1628
21;2021-03-15;145;1;6085;1629
21;2021-03-16;165;5;6250;1634
21;2021-03-17;107;0;6357;1634
21;2021-03-18;123;5;6480;1639
21;2021-03-19;226;2;6706;1641
21;2021-03-20;175;0;6881;1641
21;2021-03-21;0;0;6881;1641
21;2021-03-22;153;1;7034;1642
21;2021-03-23;289;0;7323;1642
21;2021-03-24;334;8;7657;1650
21;2021-03-25;455;7;8112;1657
21;2021-03-26;484;6;8596;1663
21;2021-03-27;218;0;8814;1663
21;2021-03-28;18;0;8832;1663
21;2021-03-29;244;35;9076;1698
21;2021-03-30;336;55;9412;1753
21;2021-03-31;276;36;9688;1789
21;2021-04-01;300;43;9988;1832
22;2020-12-28;0;0;0;0
22;2020-12-29;0;0;0;0
22;2020-12-30;0;0;0;0
22;2020-12-31;0;0;0;0
22;2021-01-01;0;0;0;0
22;2021-01-02;1;0;1;0
22;2021-01-03;0;0;1;0
22;2021-01-04;0;0;1;0
22;2021-01-05;8;0;9;0
22;2021-01-06;6;0;15;0
22;2021-01-07;10;0;25;0
22;2021-01-08;21;0;46;0
22;2021-01-09;0;0;46;0
22;2021-01-10;0;0;46;0
22;2021-01-11;18;0;64;0
22;2021-01-12;63;0;127;0
22;2021-01-13;41;0;168;0
22;2021-01-14;50;0;218;0
22;2021-01-15;51;0;269;0
22;2021-01-16;11;0;280;0
22;2021-01-17;0;0;280;0
22;2021-01-18;18;0;298;0
22;2021-01-19;54;0;352;0
22;2021-01-20;40;0;392;0
22;2021-01-21;45;0;437;0
22;2021-01-22;49;0;486;0
22;2021-01-23;7;0;493;0
22;2021-01-24;0;0;493;0
22;2021-01-25;43;1;536;1
22;2021-01-26;50;7;586;8
22;2021-01-27;123;8;709;16
22;2021-01-28;192;13;901;29
22;2021-01-29;105;10;1006;39
22;2021-01-30;8;0;1014;39
22;2021-01-31;0;0;1014;39
22;2021-02-01;27;17;1041;56
22;2021-02-02;34;42;1075;98
22;2021-02-03;45;31;1120;129
22;2021-02-04;33;40;1153;169
22;2021-02-05;33;52;1186;221
22;2021-02-06;13;0;1199;221
22;2021-02-07;0;0;1199;221
22;2021-02-08;19;9;1218;230
22;2021-02-09;23;45;1241;275
22;2021-02-10;17;20;1258;295
22;2021-02-11;49;30;1307;325
22;2021-02-12;21;24;1328;349
22;2021-02-13;12;0;1340;349
22;2021-02-14;0;0;1340;349
22;2021-02-15;34;41;1374;390
22;2021-02-16;51;51;1425;441
22;2021-02-17;58;98;1483;539
22;2021-02-18;126;155;1609;694
22;2021-02-19;93;93;1702;787
22;2021-02-20;23;3;1725;790
22;2021-02-21;0;0;1725;790
22;2021-02-22;22;42;1747;832
22;2021-02-23;53;42;1800;874
22;2021-02-24;57;46;1857;920
22;2021-02-25;261;53;2118;973
22;2021-02-26;294;39;2412;1012
22;2021-02-27;162;8;2574;1020
22;2021-02-28;4;0;2578;1020
22;2021-03-01;47;18;2625;1038
22;2021-03-02;92;30;2717;1068
22;2021-03-03;166;42;2883;1110
22;2021-03-04;240;23;3123;1133
22;2021-03-05;298;29;3421;1162
22;2021-03-06;177;10;3598;1172
22;2021-03-07;35;0;3633;1172
22;2021-03-08;110;26;3743;1198
22;2021-03-09;226;30;3969;1228
22;2021-03-10;227;60;4196;1288
22;2021-03-11;296;92;4492;1380
22;2021-03-12;457;47;4949;1427
22;2021-03-13;288;8;5237;1435
22;2021-03-14;38;0;5275;1435
22;2021-03-15;122;28;5397;1463
22;2021-03-16;89;32;5486;1495
22;2021-03-17;199;37;5685;1532
22;2021-03-18;218;52;5903;1584
22;2021-03-19;370;41;6273;1625
22;2021-03-20;232;10;6505;1635
22;2021-03-21;0;0;6505;1635
22;2021-03-22;214;16;6719;1651
22;2021-03-23;300;60;7019;1711
22;2021-03-24;369;51;7388;1762
22;2021-03-25;446;35;7834;1797
22;2021-03-26;454;32;8288;1829
22;2021-03-27;230;13;8518;1842
22;2021-03-28;20;0;8538;1842
22;2021-03-29;327;32;8865;1874
22;2021-03-30;369;46;9234;1920
22;2021-03-31;399;41;9633;1961
22;2021-04-01;491;45;10124;2006
23;2020-12-28;0;0;0;0
23;2020-12-29;0;0;0;0
23;2020-12-30;0;0;0;0
23;2020-12-31;0;0;0;0
23;2021-01-01;0;0;0;0
23;2021-01-02;0;0;0;0
23;2021-01-03;0;0;0;0
23;2021-01-04;0;0;0;0
23;2021-01-05;1;0;1;0
23;2021-01-06;2;0;3;0
23;2021-01-07;11;0;14;0
23;2021-01-08;12;0;26;0
23;2021-01-09;0;0;26;0
23;2021-01-10;0;0;26;0
23;2021-01-11;18;0;44;0
23;2021-01-12;14;0;58;0
23;2021-01-13;31;0;89;0
23;2021-01-14;14;0;103;0
23;2021-01-15;22;0;125;0
23;2021-01-16;8;0;133;0
23;2021-01-17;0;0;133;0
23;2021-01-18;8;0;141;0
23;2021-01-19;18;0;159;0
23;2021-01-20;20;0;179;0
23;2021-01-21;20;0;199;0
23;2021-01-22;20;0;219;0
23;2021-01-23;26;0;245;0
23;2021-01-24;0;0;245;0
23;2021-01-25;21;5;266;5
23;2021-01-26;20;3;286;8
23;2021-01-27;14;1;300;9
23;2021-01-28;12;6;312;15
23;2021-01-29;27;7;339;22
23;2021-01-30;7;4;346;26
23;2021-01-31;0;0;346;26
23;2021-02-01;9;15;355;41
23;2021-02-02;9;11;364;52
23;2021-02-03;10;13;374;65
23;2021-02-04;9;14;383;79
23;2021-02-05;12;18;395;97
23;2021-02-06;3;8;398;105
23;2021-02-07;0;0;398;105
23;2021-02-08;8;14;406;119
23;2021-02-09;2;15;408;134
23;2021-02-10;9;13;417;147
23;2021-02-11;13;29;430;176
23;2021-02-12;12;15;442;191
23;2021-02-13;0;12;442;203
23;2021-02-14;0;0;442;203
23;2021-02-15;14;23;456;226
23;2021-02-16;8;28;464;254
23;2021-02-17;5;21;469;275
23;2021-02-18;19;13;488;288
23;2021-02-19;3;12;491;300
23;2021-02-20;0;4;491;304
23;2021-02-21;0;0;491;304
23;2021-02-22;12;9;503;313
23;2021-02-23;9;7;512;320
23;2021-02-24;16;9;528;329
23;2021-02-25;51;9;579;338
23;2021-02-26;63;21;642;359
23;2021-02-27;22;0;664;359
23;2021-02-28;0;0;664;359
23;2021-03-01;19;9;683;368
23;2021-03-02;56;6;739;374
23;2021-03-03;26;3;765;377
23;2021-03-04;36;7;801;384
23;2021-03-05;85;7;886;391
23;2021-03-06;95;1;981;392
23;2021-03-07;38;0;1019;392
23;2021-03-08;21;7;1040;399
23;2021-03-09;39;10;1079;409
23;2021-03-10;31;2;1110;411
23;2021-03-11;48;8;1158;419
23;2021-03-12;105;2;1263;421
23;2021-03-13;69;1;1332;422
23;2021-03-14;14;0;1346;422
23;2021-03-15;16;6;1362;428
23;2021-03-16;7;6;1369;434
23;2021-03-17;8;7;1377;441
23;2021-03-18;15;6;1392;447
23;2021-03-19;21;7;1413;454
23;2021-03-20;97;4;1510;458
23;2021-03-21;29;0;1539;458
23;2021-03-22;21;13;1560;471
23;2021-03-23;44;10;1604;481
23;2021-03-24;44;5;1648;486
23;2021-03-25;91;5;1739;491
23;2021-03-26;82;12;1821;503
23;2021-03-27;67;4;1888;507
23;2021-03-28;0;0;1888;507
23;2021-03-29;35;11;1923;518
23;2021-03-30;49;7;1972;525
23;2021-03-31;38;6;2010;531
23;2021-04-01;48;4;2058;535
24;2020-12-28;0;0;0;0
24;2020-12-29;0;0;0;0
24;2020-12-30;0;0;0;0
24;2020-12-31;0;0;0;0
24;2021-01-01;0;0;0;0
24;2021-01-02;0;0;0;0
24;2021-01-03;0;0;0;0
24;2021-01-04;0;0;0;0
24;2021-01-05;0;0;0;0
24;2021-01-06;0;0;0;0
24;2021-01-07;10;0;10;0
24;2021-01-08;22;0;32;0
24;2021-01-09;16;0;48;0
24;2021-01-10;4;0;52;0
24;2021-01-11;15;0;67;0
24;2021-01-12;29;0;96;0
24;2021-01-13;15;0;111;0
24;2021-01-14;67;0;178;0
24;2021-01-15;55;0;233;0
24;2021-01-16;6;0;239;0
24;2021-01-17;0;0;239;0
24;2021-01-18;40;0;279;0
24;2021-01-19;40;0;319;0
24;2021-01-20;51;0;370;0
24;2021-01-21;32;0;402;0
24;2021-01-22;28;0;430;0
24;2021-01-23;6;0;436;0
24;2021-01-24;0;0;436;0
24;2021-01-25;41;0;477;0
24;2021-01-26;32;2;509;2
24;2021-01-27;79;0;588;2
24;2021-01-28;96;13;684;15
24;2021-01-29;80;9;764;24
24;2021-01-30;30;0;794;24
24;2021-01-31;0;0;794;24
24;2021-02-01;32;13;826;37
24;2021-02-02;32;30;858;67
24;2021-02-03;38;36;896;103
24;2021-02-04;62;36;958;139
24;2021-02-05;41;35;999;174
24;2021-02-06;13;2;1012;176
24;2021-02-07;0;0;1012;176
24;2021-02-08;19;23;1031;199
24;2021-02-09;33;12;1064;211
24;2021-02-10;34;27;1098;238
24;2021-02-11;45;61;1143;299
24;2021-02-12;24;36;1167;335
24;2021-02-13;6;3;1173;338
24;2021-02-14;2;0;1175;338
24;2021-02-15;9;22;1184;360
24;2021-02-16;37;42;1221;402
24;2021-02-17;45;84;1266;486
24;2021-02-18;39;73;1305;559
24;2021-02-19;44;58;1349;617
24;2021-02-20;10;6;1359;623
24;2021-02-21;4;0;1363;623
24;2021-02-22;36;13;1399;636
24;2021-02-23;32;37;1431;673
24;2021-02-24;40;38;1471;711
24;2021-02-25;101;53;1572;764
24;2021-02-26;222;60;1794;824
24;2021-02-27;153;30;1947;854
24;2021-02-28;10;1;1957;855
24;2021-03-01;53;14;2010;869
24;2021-03-02;102;18;2112;887
24;2021-03-03;107;49;2219;936
24;2021-03-04;203;38;2422;974
24;2021-03-05;245;43;2667;1017
24;2021-03-06;311;8;2978;1025
24;2021-03-07;33;0;3011;1025
24;2021-03-08;44;16;3055;1041
24;2021-03-09;135;34;3190;1075
24;2021-03-10;121;29;3311;1104
24;2021-03-11;200;54;3511;1158
24;2021-03-12;296;29;3807;1187
24;2021-03-13;230;6;4037;1193
24;2021-03-14;14;2;4051;1195
24;2021-03-15;60;13;4111;1208
24;2021-03-16;53;10;4164;1218
24;2021-03-17;52;21;4216;1239
24;2021-03-18;43;40;4259;1279
24;2021-03-19;113;45;4372;1324
24;2021-03-20;131;6;4503;1330
24;2021-03-21;2;0;4505;1330
24;2021-03-22;75;26;4580;1356
24;2021-03-23;141;19;4721;1375
24;2021-03-24;164;18;4885;1393
24;2021-03-25;197;30;5082;1423
24;2021-03-26;221;16;5303;1439
24;2021-03-27;157;2;5460;1441
24;2021-03-28;9;0;5469;1441
24;2021-03-29;127;19;5596;1460
24;2021-03-30;213;15;5809;1475
24;2021-03-31;189;8;5998;1483
24;2021-04-01;203;22;6201;1505
25;2020-12-28;0;0;0;0
25;2020-12-29;0;0;0;0
25;2020-12-30;0;0;0;0
25;2020-12-31;0;0;0;0
25;2021-01-01;0;0;0;0
25;2021-01-02;0;0;0;0
25;2021-01-03;0;0;0;0
25;2021-01-04;0;0;0;0
25;2021-01-05;0;0;0;0
25;2021-01-06;5;0;5;0
25;2021-01-07;18;0;23;0
25;2021-01-08;24;0;47;0
25;2021-01-09;15;0;62;0
25;2021-01-10;0;0;62;0
25;2021-01-11;44;0;106;0
25;2021-01-12;38;0;144;0
25;2021-01-13;54;0;198;0
25;2021-01-14;69;0;267;0
25;2021-01-15;45;0;312;0
25;2021-01-16;23;0;335;0
25;2021-01-17;6;0;341;0
25;2021-01-18;53;0;394;0
25;2021-01-19;35;0;429;0
25;2021-01-20;48;0;477;0
25;2021-01-21;71;0;548;0
25;2021-01-22;58;0;606;0
25;2021-01-23;15;0;621;0
25;2021-01-24;4;0;625;0
25;2021-01-25;52;0;677;0
25;2021-01-26;38;1;715;1
25;2021-01-27;54;5;769;6
25;2021-01-28;54;8;823;14
25;2021-01-29;41;14;864;28
25;2021-01-30;18;9;882;37
25;2021-01-31;0;0;882;37
25;2021-02-01;31;14;913;51
25;2021-02-02;34;35;947;86
25;2021-02-03;33;31;980;117
25;2021-02-04;38;32;1018;149
25;2021-02-05;22;46;1040;195
25;2021-02-06;9;15;1049;210
25;2021-02-07;0;0;1049;210
25;2021-02-08;14;17;1063;227
25;2021-02-09;33;23;1096;250
25;2021-02-10;37;10;1133;260
25;2021-02-11;25;40;1158;300
25;2021-02-12;20;24;1178;324
25;2021-02-13;6;11;1184;335
25;2021-02-14;0;0;1184;335
25;2021-02-15;9;58;1193;393
25;2021-02-16;8;64;1201;457
25;2021-02-17;7;59;1208;516
25;2021-02-18;8;49;1216;565
25;2021-02-19;7;64;1223;629
25;2021-02-20;0;17;1223;646
25;2021-02-21;0;8;1223;654
25;2021-02-22;2;47;1225;701
25;2021-02-23;13;33;1238;734
25;2021-02-24;19;44;1257;778
25;2021-02-25;188;39;1445;817
25;2021-02-26;193;37;1638;854
25;2021-02-27;113;14;1751;868
25;2021-02-28;1;0;1752;868
25;2021-03-01;83;30;1835;898
25;2021-03-02;144;33;1979;931
25;2021-03-03;106;36;2085;967
25;2021-03-04;270;37;2355;1004
25;2021-03-05;419;7;2774;1011
25;2021-03-06;272;8;3046;1019
25;2021-03-07;1;0;3047;1019
25;2021-03-08;90;24;3137;1043
25;2021-03-09;180;40;3317;1083
25;2021-03-10;160;34;3477;1117
25;2021-03-11;244;25;3721;1142
25;2021-03-12;304;18;4025;1160
25;2021-03-13;248;3;4273;1163
25;2021-03-14;3;0;4276;1163
25;2021-03-15;122;3;4398;1166
25;2021-03-16;107;1;4505;1167
25;2021-03-17;110;5;4615;1172
25;2021-03-18;107;3;4722;1175
25;2021-03-19;189;4;4911;1179
25;2021-03-20;116;0;5027;1179
25;2021-03-21;5;0;5032;1179
25;2021-03-22;156;3;5188;1182
25;2021-03-23;216;3;5404;1185
25;2021-03-24;311;1;5715;1186
25;2021-03-25;383;16;6098;1202
25;2021-03-26;462;6;6560;1208
25;2021-03-27;152;4;6712;1212
25;2021-03-28;16;4;6728;1216
25;2021-03-29;234;15;6962;1231
25;2021-03-30;266;12;7228;1243
25;2021-03-31;287;27;7515;1270
25;2021-04-01;282;57;7797;1327
26;2020-12-28;0;0;0;0
26;2020-12-29;0;0;0;0
26;2020-12-30;0;0;0;0
26;2020-12-31;0;0;0;0
26;2021-01-01;0;0;0;0
26;2021-01-02;0;0;0;0
26;2021-01-03;0;0;0;0
26;2021-01-04;0;0;0;0
26;2021-01-05;0;0;0;0
26;2021-01-06;0;0;0;0
26;2021-01-07;5;0;5;0
26;2021-01-08;13;0;18;0
26;2021-01-09;0;0;18;0
26;2021-01-10;0;0;18;0
26;2021-01-11;26;0;44;0
26;2021-01-12;26;0;70;0
26;2021-01-13;42;0;112;0
26;2021-01-14;54;0;166;0
26;2021-01-15;45;0;211;0
26;2021-01-16;17;0;228;0
26;2021-01-17;0;0;228;0
26;2021-01-18;29;0;257;0
26;2021-01-19;38;0;295;0
26;2021-01-20;38;0;333;0
26;2021-01-21;44;0;377;0
26;2021-01-22;36;0;413;0
26;2021-01-23;25;0;438;0
26;2021-01-24;0;0;438;0
26;2021-01-25;40;0;478;0
26;2021-01-26;48;0;526;0
26;2021-01-27;43;0;569;0
26;2021-01-28;86;10;655;10
26;2021-01-29;68;6;723;16
26;2021-01-30;40;0;763;16
26;2021-01-31;1;0;764;16
26;2021-02-01;40;18;804;34
26;2021-02-02;51;33;855;67
26;2021-02-03;48;40;903;107
26;2021-02-04;55;52;958;159
26;2021-02-05;44;24;1002;183
26;2021-02-06;9;10;1011;193
26;2021-02-07;2;0;1013;193
26;2021-02-08;21;22;1034;215
26;2021-02-09;40;34;1074;249
26;2021-02-10;29;10;1103;259
26;2021-02-11;32;24;1135;283
26;2021-02-12;31;40;1166;323
26;2021-02-13;19;14;1185;337
26;2021-02-14;1;0;1186;337
26;2021-02-15;30;25;1216;362
26;2021-02-16;9;23;1225;385
26;2021-02-17;8;31;1233;416
26;2021-02-18;23;54;1256;470
26;2021-02-19;26;57;1282;527
26;2021-02-20;10;17;1292;544
26;2021-02-21;0;0;1292;544
26;2021-02-22;19;28;1311;572
26;2021-02-23;26;55;1337;627
26;2021-02-24;33;62;1370;689
26;2021-02-25;139;57;1509;746
26;2021-02-26;190;32;1699;778
26;2021-02-27;68;33;1767;811
26;2021-02-28;0;1;1767;812
26;2021-03-01;94;38;1861;850
26;2021-03-02;177;34;2038;884
26;2021-03-03;188;31;2226;915
26;2021-03-04;291;28;2517;943
26;2021-03-05;364;28;2881;971
26;2021-03-06;383;13;3264;984
26;2021-03-07;189;0;3453;984
26;2021-03-08;90;22;3543;1006
26;2021-03-09;205;24;3748;1030
26;2021-03-10;174;20;3922;1050
26;2021-03-11;289;27;4211;1077
26;2021-03-12;388;24;4599;1101
26;2021-03-13;295;13;4894;1114
26;2021-03-14;9;1;4903;1115
26;2021-03-15;161;12;5064;1127
26;2021-03-16;66;20;5130;1147
26;2021-03-17;90;15;5220;1162
26;2021-03-18;84;22;5304;1184
26;2021-03-19;268;12;5572;1196
26;2021-03-20;120;7;5692;1203
26;2021-03-21;3;0;5695;1203
26;2021-03-22;191;30;5886;1233
26;2021-03-23;288;9;6174;1242
26;2021-03-24;300;13;6474;1255
26;2021-03-25;349;11;6823;1266
26;2021-03-26;393;11;7216;1277
26;2021-03-27;136;10;7352;1287
26;2021-03-28;13;0;7365;1287
26;2021-03-29;215;12;7580;1299
26;2021-03-30;290;19;7870;1318
26;2021-03-31;253;28;8123;1346
26;2021-04-01;262;44;8385;1390
27;2020-12-28;0;0;0;0
27;2020-12-29;0;0;0;0
27;2020-12-30;0;0;0;0
27;2020-12-31;0;0;0;0
27;2021-01-01;0;0;0;0
27;2021-01-02;0;0;0;0
27;2021-01-03;0;0;0;0
27;2021-01-04;0;0;0;0
27;2021-01-05;0;0;0;0
27;2021-01-06;25;0;25;0
27;2021-01-07;36;0;61;0
27;2021-01-08;43;0;104;0
27;2021-01-09;9;0;113;0
27;2021-01-10;14;0;127;0
27;2021-01-11;29;0;156;0
27;2021-01-12;37;0;193;0
27;2021-01-13;48;0;241;0
27;2021-01-14;80;0;321;0
27;2021-01-15;75;0;396;0
27;2021-01-16;24;1;420;1
27;2021-01-17;12;0;432;1
27;2021-01-18;40;0;472;1
27;2021-01-19;54;0;526;1
27;2021-01-20;36;0;562;1
27;2021-01-21;28;0;590;1
27;2021-01-22;38;0;628;1
27;2021-01-23;16;0;644;1
27;2021-01-24;10;1;654;2
27;2021-01-25;21;2;675;4
27;2021-01-26;19;5;694;9
27;2021-01-27;20;13;714;22
27;2021-01-28;28;24;742;46
27;2021-01-29;27;15;769;61
27;2021-01-30;12;6;781;67
27;2021-01-31;0;1;781;68
27;2021-02-01;21;32;802;100
27;2021-02-02;16;28;818;128
27;2021-02-03;21;23;839;151
27;2021-02-04;35;87;874;238
27;2021-02-05;37;69;911;307
27;2021-02-06;5;9;916;316
27;2021-02-07;2;6;918;322
27;2021-02-08;20;20;938;342
27;2021-02-09;15;30;953;372
27;2021-02-10;19;36;972;408
27;2021-02-11;21;24;993;432
27;2021-02-12;11;30;1004;462
27;2021-02-13;13;13;1017;475
27;2021-02-14;0;7;1017;482
27;2021-02-15;20;29;1037;511
27;2021-02-16;12;26;1049;537
27;2021-02-17;13;26;1062;563
27;2021-02-18;52;31;1114;594
27;2021-02-19;12;33;1126;627
27;2021-02-20;13;12;1139;639
27;2021-02-21;0;8;1139;647
27;2021-02-22;30;21;1169;668
27;2021-02-23;38;19;1207;687
27;2021-02-24;74;29;1281;716
27;2021-02-25;175;40;1456;756
27;2021-02-26;253;43;1709;799
27;2021-02-27;144;11;1853;810
27;2021-02-28;35;2;1888;812
27;2021-03-01;63;19;1951;831
27;2021-03-02;134;20;2085;851
27;2021-03-03;144;18;2229;869
27;2021-03-04;160;11;2389;880
27;2021-03-05;354;9;2743;889
27;2021-03-06;318;6;3061;895
27;2021-03-07;103;0;3164;895
27;2021-03-08;120;14;3284;909
27;2021-03-09;195;10;3479;919
27;2021-03-10;228;13;3707;932
27;2021-03-11;267;7;3974;939
27;2021-03-12;493;8;4467;947
27;2021-03-13;373;5;4840;952
27;2021-03-14;92;0;4932;952
27;2021-03-15;168;8;5100;960
27;2021-03-16;119;8;5219;968
27;2021-03-17;152;11;5371;979
27;2021-03-18;125;14;5496;993
27;2021-03-19;266;7;5762;1000
27;2021-03-20;133;3;5895;1003
27;2021-03-21;61;0;5956;1003
27;2021-03-22;138;28;6094;1031
27;2021-03-23;216;26;6310;1057
27;2021-03-24;191;31;6501;1088
27;2021-03-25;338;39;6839;1127
27;2021-03-26;432;28;7271;1155
27;2021-03-27;224;11;7495;1166
27;2021-03-28;168;6;7663;1172
27;2021-03-29;172;59;7835;1231
27;2021-03-30;224;65;8059;1296
27;2021-03-31;176;65;8235;1361
27;2021-04-01;231;53;8466;1414
28;2020-12-28;0;0;0;0
28;2020-12-29;0;0;0;0
28;2020-12-30;0;0;0;0
28;2020-12-31;0;0;0;0
28;2021-01-01;0;0;0;0
28;2021-01-02;0;0;0;0
28;2021-01-03;0;0;0;0
28;2021-01-04;0;0;0;0
28;2021-01-05;0;0;0;0
28;2021-01-06;0;0;0;0
28;2021-01-07;3;0;3;0
28;2021-01-08;9;0;12;0
28;2021-01-09;8;0;20;0
28;2021-01-10;0;0;20;0
28;2021-01-11;8;0;28;0
28;2021-01-12;21;0;49;0
28;2021-01-13;37;0;86;0
28;2021-01-14;34;0;120;0
28;2021-01-15;41;0;161;0
28;2021-01-16;33;0;194;0
28;2021-01-17;1;0;195;0
28;2021-01-18;18;0;213;0
28;2021-01-19;19;0;232;0
28;2021-01-20;29;0;261;0
28;2021-01-21;35;0;296;0
28;2021-01-22;18;0;314;0
28;2021-01-23;16;0;330;0
28;2021-01-24;0;0;330;0
28;2021-01-25;18;0;348;0
28;2021-01-26;24;0;372;0
28;2021-01-27;77;0;449;0
28;2021-01-28;53;2;502;2
28;2021-01-29;35;6;537;8
28;2021-01-30;11;5;548;13
28;2021-01-31;0;0;548;13
28;2021-02-01;8;10;556;23
28;2021-02-02;23;17;579;40
28;2021-02-03;16;21;595;61
28;2021-02-04;20;15;615;76
28;2021-02-05;14;29;629;105
28;2021-02-06;3;22;632;127
28;2021-02-07;0;0;632;127
28;2021-02-08;2;9;634;136
28;2021-02-09;10;12;644;148
28;2021-02-10;57;19;701;167
28;2021-02-11;61;21;762;188
28;2021-02-12;40;17;802;205
28;2021-02-13;3;22;805;227
28;2021-02-14;0;0;805;227
28;2021-02-15;8;25;813;252
28;2021-02-16;20;28;833;280
28;2021-02-17;52;54;885;334
28;2021-02-18;34;64;919;398
28;2021-02-19;51;38;970;436
28;2021-02-20;10;15;980;451
28;2021-02-21;0;0;980;451
28;2021-02-22;14;15;994;466
28;2021-02-23;12;12;1006;478
28;2021-02-24;31;40;1037;518
28;2021-02-25;125;13;1162;531
28;2021-02-26;159;17;1321;548
28;2021-02-27;141;5;1462;553
28;2021-02-28;11;0;1473;553
28;2021-03-01;49;0;1522;553
28;2021-03-02;36;21;1558;574
28;2021-03-03;57;18;1615;592
28;2021-03-04;165;16;1780;608
28;2021-03-05;204;9;1984;617
28;2021-03-06;213;1;2197;618
28;2021-03-07;19;0;2216;618
28;2021-03-08;53;4;2269;622
28;2021-03-09;131;11;2400;633
28;2021-03-10;153;65;2553;698
28;2021-03-11;221;64;2774;762
28;2021-03-12;360;50;3134;812
28;2021-03-13;267;4;3401;816
28;2021-03-14;15;0;3416;816
28;2021-03-15;105;4;3521;820
28;2021-03-16;50;9;3571;829
28;2021-03-17;51;21;3622;850
28;2021-03-18;81;20;3703;870
28;2021-03-19;186;31;3889;901
28;2021-03-20;140;2;4029;903
28;2021-03-21;6;0;4035;903
28;2021-03-22;87;13;4122;916
28;2021-03-23;167;11;4289;927
28;2021-03-24;147;18;4436;945
28;2021-03-25;221;19;4657;964
28;2021-03-26;260;11;4917;975
28;2021-03-27;69;0;4986;975
28;2021-03-28;4;0;4990;975
28;2021-03-29;102;18;5092;993
28;2021-03-30;209;13;5301;1006
28;2021-03-31;232;16;5533;1022
28;2021-04-01;197;16;5730;1038
29;2020-12-28;0;0;0;0
29;2020-12-29;0;0;0;0
29;2020-12-30;0;0;0;0
29;2020-12-31;0;0;0;0
29;2021-01-01;0;0;0;0
29;2021-01-02;0;0;0;0
29;2021-01-03;0;0;0;0
29;2021-01-04;0;0;0;0
29;2021-01-05;0;0;0;0
29;2021-01-06;4;0;4;0
29;2021-01-07;14;0;18;0
29;2021-01-08;44;0;62;0
29;2021-01-09;0;0;62;0
29;2021-01-10;1;0;63;0
29;2021-01-11;61;0;124;0
29;2021-01-12;74;0;198;0
29;2021-01-13;82;0;280;0
29;2021-01-14;71;0;351;0
29;2021-01-15;92;0;443;0
29;2021-01-16;31;0;474;0
29;2021-01-17;15;0;489;0
29;2021-01-18;55;0;544;0
29;2021-01-19;70;0;614;0
29;2021-01-20;110;0;724;0
29;2021-01-21;256;0;980;0
29;2021-01-22;190;0;1170;0
29;2021-01-23;28;0;1198;0
29;2021-01-24;14;0;1212;0
29;2021-01-25;33;1;1245;1
29;2021-01-26;51;1;1296;2
29;2021-01-27;88;3;1384;5
29;2021-01-28;42;12;1426;17
29;2021-01-29;37;31;1463;48
29;2021-01-30;10;0;1473;48
29;2021-01-31;4;0;1477;48
29;2021-02-01;26;51;1503;99
29;2021-02-02;52;48;1555;147
29;2021-02-03;58;59;1613;206
29;2021-02-04;58;29;1671;235
29;2021-02-05;24;50;1695;285
29;2021-02-06;5;15;1700;300
29;2021-02-07;7;12;1707;312
29;2021-02-08;29;44;1736;356
29;2021-02-09;59;90;1795;446
29;2021-02-10;62;87;1857;533
29;2021-02-11;126;234;1983;767
29;2021-02-12;159;176;2142;943
29;2021-02-13;25;19;2167;962
29;2021-02-14;0;12;2167;974
29;2021-02-15;16;34;2183;1008
29;2021-02-16;57;43;2240;1051
29;2021-02-17;81;54;2321;1105
29;2021-02-18;133;46;2454;1151
29;2021-02-19;119;47;2573;1198
29;2021-02-20;19;13;2592;1211
29;2021-02-21;17;6;2609;1217
29;2021-02-22;72;31;2681;1248
29;2021-02-23;119;44;2800;1292
29;2021-02-24;189;47;2989;1339
29;2021-02-25;734;54;3723;1393
29;2021-02-26;856;23;4579;1416
29;2021-02-27;375;11;4954;1427
29;2021-02-28;23;4;4977;1431
29;2021-03-01;147;28;5124;1459
29;2021-03-02;287;48;5411;1507
29;2021-03-03;434;69;5845;1576
29;2021-03-04;689;142;6534;1718
29;2021-03-05;823;116;7357;1834
29;2021-03-06;497;13;7854;1847
29;2021-03-07;36;7;7890;1854
29;2021-03-08;200;38;8090;1892
29;2021-03-09;373;54;8463;1946
29;2021-03-10;395;47;8858;1993
29;2021-03-11;696;68;9554;2061
29;2021-03-12;988;50;10542;2111
29;2021-03-13;522;12;11064;2123
29;2021-03-14;35;0;11099;2123
29;2021-03-15;220;12;11319;2135
29;2021-03-16;129;46;11448;2181
29;2021-03-17;104;61;11552;2242
29;2021-03-18;95;113;11647;2355
29;2021-03-19;425;106;12072;2461
29;2021-03-20;208;16;12280;2477
29;2021-03-21;12;1;12292;2478
29;2021-03-22;220;49;12512;2527
29;2021-03-23;384;96;12896;2623
29;2021-03-24;461;84;13357;2707
29;2021-03-25;625;116;13982;2823
29;2021-03-26;748;77;14730;2900
29;2021-03-27;309;25;15039;2925
29;2021-03-28;14;0;15053;2925
29;2021-03-29;260;47;15313;2972
29;2021-03-30;365;49;15678;3021
29;2021-03-31;375;63;16053;3084
29;2021-04-01;454;80;16507;3164
2A;2020-12-28;0;0;0;0
2A;2020-12-29;0;0;0;0
2A;2020-12-30;0;0;0;0
2A;2020-12-31;0;0;0;0
2A;2021-01-01;0;0;0;0
2A;2021-01-02;0;0;0;0
2A;2021-01-03;0;0;0;0
2A;2021-01-04;0;0;0;0
2A;2021-01-05;0;0;0;0
2A;2021-01-06;1;0;1;0
2A;2021-01-07;13;0;14;0
2A;2021-01-08;14;0;28;0
2A;2021-01-09;7;0;35;0
2A;2021-01-10;3;0;38;0
2A;2021-01-11;12;0;50;0
2A;2021-01-12;8;0;58;0
2A;2021-01-13;17;0;75;0
2A;2021-01-14;18;0;93;0
2A;2021-01-15;21;0;114;0
2A;2021-01-16;6;0;120;0
2A;2021-01-17;0;0;120;0
2A;2021-01-18;9;0;129;0
2A;2021-01-19;33;0;162;0
2A;2021-01-20;21;0;183;0
2A;2021-01-21;18;0;201;0
2A;2021-01-22;17;0;218;0
2A;2021-01-23;14;0;232;0
2A;2021-01-24;4;0;236;0
2A;2021-01-25;14;0;250;0
2A;2021-01-26;22;2;272;2
2A;2021-01-27;16;1;288;3
2A;2021-01-28;20;10;308;13
2A;2021-01-29;22;10;330;23
2A;2021-01-30;13;4;343;27
2A;2021-01-31;8;1;351;28
2A;2021-02-01;13;8;364;36
2A;2021-02-02;13;11;377;47
2A;2021-02-03;27;11;404;58
2A;2021-02-04;11;11;415;69
2A;2021-02-05;16;13;431;82
2A;2021-02-06;12;8;443;90
2A;2021-02-07;1;2;444;92
2A;2021-02-08;10;20;454;112
2A;2021-02-09;10;26;464;138
2A;2021-02-10;15;11;479;149
2A;2021-02-11;14;25;493;174
2A;2021-02-12;23;18;516;192
2A;2021-02-13;19;2;535;194
2A;2021-02-14;10;2;545;196
2A;2021-02-15;12;7;557;203
2A;2021-02-16;26;29;583;232
2A;2021-02-17;9;4;592;236
2A;2021-02-18;32;5;624;241
2A;2021-02-19;15;17;639;258
2A;2021-02-20;13;10;652;268
2A;2021-02-21;4;7;656;275
2A;2021-02-22;9;19;665;294
2A;2021-02-23;21;12;686;306
2A;2021-02-24;8;16;694;322
2A;2021-02-25;17;15;711;337
2A;2021-02-26;23;13;734;350
2A;2021-02-27;25;7;759;357
2A;2021-02-28;6;6;765;363
2A;2021-03-01;29;14;794;377
2A;2021-03-02;37;6;831;383
2A;2021-03-03;43;19;874;402
2A;2021-03-04;74;15;948;417
2A;2021-03-05;132;21;1080;438
2A;2021-03-06;147;7;1227;445
2A;2021-03-07;104;1;1331;446
2A;2021-03-08;113;7;1444;453
2A;2021-03-09;137;11;1581;464
2A;2021-03-10;70;11;1651;475
2A;2021-03-11;105;12;1756;487
2A;2021-03-12;60;16;1816;503
2A;2021-03-13;67;14;1883;517
2A;2021-03-14;43;15;1926;532
2A;2021-03-15;31;11;1957;543
2A;2021-03-16;53;30;2010;573
2A;2021-03-17;84;12;2094;585
2A;2021-03-18;60;18;2154;603
2A;2021-03-19;53;14;2207;617
2A;2021-03-20;140;15;2347;632
2A;2021-03-21;95;4;2442;636
2A;2021-03-22;37;6;2479;642
2A;2021-03-23;74;12;2553;654
2A;2021-03-24;125;5;2678;659
2A;2021-03-25;124;19;2802;678
2A;2021-03-26;143;22;2945;700
2A;2021-03-27;162;11;3107;711
2A;2021-03-28;38;5;3145;716
2A;2021-03-29;40;10;3185;726
2A;2021-03-30;62;24;3247;750
2A;2021-03-31;68;22;3315;772
2A;2021-04-01;73;49;3388;821
2B;2020-12-28;0;0;0;0
2B;2020-12-29;0;0;0;0
2B;2020-12-30;0;0;0;0
2B;2020-12-31;0;0;0;0
2B;2021-01-01;0;0;0;0
2B;2021-01-02;0;0;0;0
2B;2021-01-03;0;0;0;0
2B;2021-01-04;0;0;0;0
2B;2021-01-05;0;0;0;0
2B;2021-01-06;3;0;3;0
2B;2021-01-07;18;0;21;0
2B;2021-01-08;20;0;41;0
2B;2021-01-09;6;0;47;0
2B;2021-01-10;0;0;47;0
2B;2021-01-11;8;0;55;0
2B;2021-01-12;21;0;76;0
2B;2021-01-13;7;0;83;0
2B;2021-01-14;12;0;95;0
2B;2021-01-15;30;0;125;0
2B;2021-01-16;3;0;128;0
2B;2021-01-17;0;0;128;0
2B;2021-01-18;31;0;159;0
2B;2021-01-19;28;0;187;0
2B;2021-01-20;32;0;219;0
2B;2021-01-21;19;0;238;0
2B;2021-01-22;23;0;261;0
2B;2021-01-23;2;0;263;0
2B;2021-01-24;2;0;265;0
2B;2021-01-25;9;0;274;0
2B;2021-01-26;24;0;298;0
2B;2021-01-27;20;4;318;4
2B;2021-01-28;20;12;338;16
2B;2021-01-29;20;24;358;40
2B;2021-01-30;6;5;364;45
2B;2021-01-31;3;0;367;45
2B;2021-02-01;12;9;379;54
2B;2021-02-02;18;17;397;71
2B;2021-02-03;31;8;428;79
2B;2021-02-04;28;12;456;91
2B;2021-02-05;25;16;481;107
2B;2021-02-06;4;0;485;107
2B;2021-02-07;3;0;488;107
2B;2021-02-08;14;23;502;130
2B;2021-02-09;41;19;543;149
2B;2021-02-10;33;11;576;160
2B;2021-02-11;27;17;603;177
2B;2021-02-12;11;13;614;190
2B;2021-02-13;4;1;618;191
2B;2021-02-14;4;0;622;191
2B;2021-02-15;9;11;631;202
2B;2021-02-16;13;13;644;215
2B;2021-02-17;14;14;658;229
2B;2021-02-18;16;17;674;246
2B;2021-02-19;14;21;688;267
2B;2021-02-20;2;2;690;269
2B;2021-02-21;2;2;692;271
2B;2021-02-22;13;9;705;280
2B;2021-02-23;17;17;722;297
2B;2021-02-24;13;18;735;315
2B;2021-02-25;22;19;757;334
2B;2021-02-26;55;23;812;357
2B;2021-02-27;21;6;833;363
2B;2021-02-28;0;3;833;366
2B;2021-03-01;32;10;865;376
2B;2021-03-02;43;23;908;399
2B;2021-03-03;63;27;971;426
2B;2021-03-04;100;25;1071;451
2B;2021-03-05;104;21;1175;472
2B;2021-03-06;98;5;1273;477
2B;2021-03-07;39;3;1312;480
2B;2021-03-08;31;12;1343;492
2B;2021-03-09;40;36;1383;528
2B;2021-03-10;94;29;1477;557
2B;2021-03-11;84;28;1561;585
2B;2021-03-12;129;10;1690;595
2B;2021-03-13;61;6;1751;601
2B;2021-03-14;25;5;1776;606
2B;2021-03-15;72;13;1848;619
2B;2021-03-16;58;8;1906;627
2B;2021-03-17;65;10;1971;637
2B;2021-03-18;71;15;2042;652
2B;2021-03-19;118;14;2160;666
2B;2021-03-20;82;3;2242;669
2B;2021-03-21;58;2;2300;671
2B;2021-03-22;89;12;2389;683
2B;2021-03-23;109;13;2498;696
2B;2021-03-24;109;12;2607;708
2B;2021-03-25;135;6;2742;714
2B;2021-03-26;111;11;2853;725
2B;2021-03-27;155;0;3008;725
2B;2021-03-28;117;10;3125;735
2B;2021-03-29;98;8;3223;743
2B;2021-03-30;116;20;3339;763
2B;2021-03-31;134;14;3473;777
2B;2021-04-01;143;27;3616;804
30;2020-12-28;0;0;0;0
30;2020-12-29;0;0;0;0
30;2020-12-30;0;0;0;0
30;2020-12-31;0;0;0;0
30;2021-01-01;0;0;0;0
30;2021-01-02;0;0;0;0
30;2021-01-03;0;0;0;0
30;2021-01-04;0;0;0;0
30;2021-01-05;0;0;0;0
30;2021-01-06;7;0;7;0
30;2021-01-07;19;0;26;0
30;2021-01-08;40;0;66;0
30;2021-01-09;34;0;100;0
30;2021-01-10;0;0;100;0
30;2021-01-11;50;0;150;0
30;2021-01-12;40;0;190;0
30;2021-01-13;38;0;228;0
30;2021-01-14;46;0;274;0
30;2021-01-15;54;0;328;0
30;2021-01-16;20;0;348;0
30;2021-01-17;0;0;348;0
30;2021-01-18;42;0;390;0
30;2021-01-19;85;0;475;0
30;2021-01-20;73;0;548;0
30;2021-01-21;53;0;601;0
30;2021-01-22;71;0;672;0
30;2021-01-23;38;0;710;0
30;2021-01-24;0;0;710;0
30;2021-01-25;44;0;754;0
30;2021-01-26;69;2;823;2
30;2021-01-27;69;4;892;6
30;2021-01-28;37;22;929;28
30;2021-01-29;45;40;974;68
30;2021-01-30;23;31;997;99
30;2021-01-31;0;0;997;99
30;2021-02-01;48;36;1045;135
30;2021-02-02;79;37;1124;172
30;2021-02-03;69;48;1193;220
30;2021-02-04;39;41;1232;261
30;2021-02-05;24;60;1256;321
30;2021-02-06;16;22;1272;343
30;2021-02-07;1;0;1273;343
30;2021-02-08;23;39;1296;382
30;2021-02-09;74;70;1370;452
30;2021-02-10;69;62;1439;514
30;2021-02-11;78;36;1517;550
30;2021-02-12;34;64;1551;614
30;2021-02-13;18;20;1569;634
30;2021-02-14;0;0;1569;634
30;2021-02-15;25;32;1594;666
30;2021-02-16;25;53;1619;719
30;2021-02-17;46;40;1665;759
30;2021-02-18;33;39;1698;798
30;2021-02-19;34;46;1732;844
30;2021-02-20;14;15;1746;859
30;2021-02-21;2;0;1748;859
30;2021-02-22;35;50;1783;909
30;2021-02-23;48;64;1831;973
30;2021-02-24;56;68;1887;1041
30;2021-02-25;158;54;2045;1095
30;2021-02-26;184;34;2229;1129
30;2021-02-27;172;30;2401;1159
30;2021-02-28;0;0;2401;1159
30;2021-03-01;152;40;2553;1199
30;2021-03-02;225;36;2778;1235
30;2021-03-03;338;50;3116;1285
30;2021-03-04;384;77;3500;1362
30;2021-03-05;360;26;3860;1388
30;2021-03-06;394;11;4254;1399
30;2021-03-07;225;0;4479;1399
30;2021-03-08;169;35;4648;1434
30;2021-03-09;313;37;4961;1471
30;2021-03-10;313;35;5274;1506
30;2021-03-11;464;33;5738;1539
30;2021-03-12;434;24;6172;1563
30;2021-03-13;327;10;6499;1573
30;2021-03-14;26;0;6525;1573
30;2021-03-15;149;31;6674;1604
30;2021-03-16;90;45;6764;1649
30;2021-03-17;88;32;6852;1681
30;2021-03-18;109;43;6961;1724
30;2021-03-19;226;22;7187;1746
30;2021-03-20;177;13;7364;1759
30;2021-03-21;12;0;7376;1759
30;2021-03-22;238;37;7614;1796
30;2021-03-23;383;31;7997;1827
30;2021-03-24;472;39;8469;1866
30;2021-03-25;556;52;9025;1918
30;2021-03-26;567;29;9592;1947
30;2021-03-27;227;18;9819;1965
30;2021-03-28;1;0;9820;1965
30;2021-03-29;327;85;10147;2050
30;2021-03-30;451;85;10598;2135
30;2021-03-31;372;84;10970;2219
30;2021-04-01;401;69;11371;2288
31;2020-12-28;0;0;0;0
31;2020-12-29;0;0;0;0
31;2020-12-30;0;0;0;0
31;2020-12-31;0;0;0;0
31;2021-01-01;0;0;0;0
31;2021-01-02;0;0;0;0
31;2021-01-03;0;0;0;0
31;2021-01-04;0;0;0;0
31;2021-01-05;7;0;7;0
31;2021-01-06;28;0;35;0
31;2021-01-07;51;0;86;0
31;2021-01-08;68;0;154;0
31;2021-01-09;32;0;186;0
31;2021-01-10;38;0;224;0
31;2021-01-11;136;0;360;0
31;2021-01-12;126;0;486;0
31;2021-01-13;116;0;602;0
31;2021-01-14;129;0;731;0
31;2021-01-15;126;0;857;0
31;2021-01-16;28;0;885;0
31;2021-01-17;20;0;905;0
31;2021-01-18;104;0;1009;0
31;2021-01-19;164;0;1173;0
31;2021-01-20;234;0;1407;0
31;2021-01-21;194;0;1601;0
31;2021-01-22;208;0;1809;0
31;2021-01-23;60;0;1869;0
31;2021-01-24;27;0;1896;0
31;2021-01-25;103;1;1999;1
31;2021-01-26;141;8;2140;9
31;2021-01-27;132;17;2272;26
31;2021-01-28;113;56;2385;82
31;2021-01-29;95;50;2480;132
31;2021-01-30;15;21;2495;153
31;2021-01-31;13;28;2508;181
31;2021-02-01;61;109;2569;290
31;2021-02-02;147;106;2716;396
31;2021-02-03;129;87;2845;483
31;2021-02-04;122;85;2967;568
31;2021-02-05;92;59;3059;627
31;2021-02-06;17;7;3076;634
31;2021-02-07;6;4;3082;638
31;2021-02-08;72;76;3154;714
31;2021-02-09;92;101;3246;815
31;2021-02-10;124;139;3370;954
31;2021-02-11;128;158;3498;1112
31;2021-02-12;86;89;3584;1201
31;2021-02-13;20;19;3604;1220
31;2021-02-14;10;18;3614;1238
31;2021-02-15;28;91;3642;1329
31;2021-02-16;53;100;3695;1429
31;2021-02-17;38;172;3733;1601
31;2021-02-18;33;129;3766;1730
31;2021-02-19;22;150;3788;1880
31;2021-02-20;6;34;3794;1914
31;2021-02-21;7;24;3801;1938
31;2021-02-22;25;110;3826;2048
31;2021-02-23;38;184;3864;2232
31;2021-02-24;37;156;3901;2388
31;2021-02-25;243;151;4144;2539
31;2021-02-26;535;87;4679;2626
31;2021-02-27;275;15;4954;2641
31;2021-02-28;18;8;4972;2649
31;2021-03-01;165;61;5137;2710
31;2021-03-02;363;113;5500;2823
31;2021-03-03;417;114;5917;2937
31;2021-03-04;763;90;6680;3027
31;2021-03-05;808;97;7488;3124
31;2021-03-06;674;20;8162;3144
31;2021-03-07;602;0;8764;3144
31;2021-03-08;233;74;8997;3218
31;2021-03-09;568;60;9565;3278
31;2021-03-10;504;71;10069;3349
31;2021-03-11;885;73;10954;3422
31;2021-03-12;959;49;11913;3471
31;2021-03-13;582;15;12495;3486
31;2021-03-14;30;2;12525;3488
31;2021-03-15;265;28;12790;3516
31;2021-03-16;118;60;12908;3576
31;2021-03-17;101;33;13009;3609
31;2021-03-18;148;29;13157;3638
31;2021-03-19;359;31;13516;3669
31;2021-03-20;184;8;13700;3677
31;2021-03-21;10;0;13710;3677
31;2021-03-22;281;20;13991;3697
31;2021-03-23;508;22;14499;3719
31;2021-03-24;556;20;15055;3739
31;2021-03-25;881;22;15936;3761
31;2021-03-26;738;31;16674;3792
31;2021-03-27;549;3;17223;3795
31;2021-03-28;272;1;17495;3796
31;2021-03-29;460;36;17955;3832
31;2021-03-30;659;15;18614;3847
31;2021-03-31;619;34;19233;3881
31;2021-04-01;748;22;19981;3903
32;2020-12-28;0;0;0;0
32;2020-12-29;0;0;0;0
32;2020-12-30;0;0;0;0
32;2020-12-31;0;0;0;0
32;2021-01-01;0;0;0;0
32;2021-01-02;0;0;0;0
32;2021-01-03;0;0;0;0
32;2021-01-04;0;0;0;0
32;2021-01-05;0;0;0;0
32;2021-01-06;0;0;0;0
32;2021-01-07;6;0;6;0
32;2021-01-08;11;0;17;0
32;2021-01-09;0;0;17;0
32;2021-01-10;0;0;17;0
32;2021-01-11;1;0;18;0
32;2021-01-12;17;0;35;0
32;2021-01-13;12;0;47;0
32;2021-01-14;23;0;70;0
32;2021-01-15;56;0;126;0
32;2021-01-16;2;0;128;0
32;2021-01-17;0;0;128;0
32;2021-01-18;23;0;151;0
32;2021-01-19;35;0;186;0
32;2021-01-20;21;0;207;0
32;2021-01-21;27;0;234;0
32;2021-01-22;13;0;247;0
32;2021-01-23;4;0;251;0
32;2021-01-24;0;0;251;0
32;2021-01-25;20;0;271;0
32;2021-01-26;36;0;307;0
32;2021-01-27;49;0;356;0
32;2021-01-28;36;5;392;5
32;2021-01-29;36;12;428;17
32;2021-01-30;6;0;434;17
32;2021-01-31;1;0;435;17
32;2021-02-01;11;0;446;17
32;2021-02-02;46;15;492;32
32;2021-02-03;22;26;514;58
32;2021-02-04;22;15;536;73
32;2021-02-05;25;29;561;102
32;2021-02-06;8;0;569;102
32;2021-02-07;0;0;569;102
32;2021-02-08;12;19;581;121
32;2021-02-09;23;25;604;146
32;2021-02-10;15;18;619;164
32;2021-02-11;14;24;633;188
32;2021-02-12;13;10;646;198
32;2021-02-13;8;0;654;198
32;2021-02-14;0;0;654;198
32;2021-02-15;3;10;657;208
32;2021-02-16;28;22;685;230
32;2021-02-17;12;31;697;261
32;2021-02-18;12;40;709;301
32;2021-02-19;11;22;720;323
32;2021-02-20;0;3;720;326
32;2021-02-21;0;0;720;326
32;2021-02-22;9;18;729;344
32;2021-02-23;30;32;759;376
32;2021-02-24;17;27;776;403
32;2021-02-25;19;14;795;417
32;2021-02-26;110;23;905;440
32;2021-02-27;79;5;984;445
32;2021-02-28;2;0;986;445
32;2021-03-01;8;11;994;456
32;2021-03-02;52;42;1046;498
32;2021-03-03;44;15;1090;513
32;2021-03-04;108;17;1198;530
32;2021-03-05;99;20;1297;550
32;2021-03-06;72;4;1369;554
32;2021-03-07;3;1;1372;555
32;2021-03-08;11;10;1383;565
32;2021-03-09;57;23;1440;588
32;2021-03-10;87;19;1527;607
32;2021-03-11;110;9;1637;616
32;2021-03-12;159;17;1796;633
32;2021-03-13;66;8;1862;641
32;2021-03-14;0;0;1862;641
32;2021-03-15;14;3;1876;644
32;2021-03-16;12;14;1888;658
32;2021-03-17;2;12;1890;670
32;2021-03-18;16;12;1906;682
32;2021-03-19;34;10;1940;692
32;2021-03-20;36;0;1976;692
32;2021-03-21;0;0;1976;692
32;2021-03-22;31;7;2007;699
32;2021-03-23;50;25;2057;724
32;2021-03-24;80;14;2137;738
32;2021-03-25;101;13;2238;751
32;2021-03-26;69;20;2307;771
32;2021-03-27;29;0;2336;771
32;2021-03-28;0;0;2336;771
32;2021-03-29;23;1;2359;772
32;2021-03-30;61;7;2420;779
32;2021-03-31;57;3;2477;782
32;2021-04-01;112;11;2589;793
33;2020-12-28;0;0;0;0
33;2020-12-29;0;0;0;0
33;2020-12-30;0;0;0;0
33;2020-12-31;0;0;0;0
33;2021-01-01;0;0;0;0
33;2021-01-02;0;0;0;0
33;2021-01-03;0;0;0;0
33;2021-01-04;0;0;0;0
33;2021-01-05;0;0;0;0
33;2021-01-06;12;0;12;0
33;2021-01-07;138;0;150;0
33;2021-01-08;131;0;281;0
33;2021-01-09;39;0;320;0
33;2021-01-10;30;0;350;0
33;2021-01-11;63;0;413;0
33;2021-01-12;108;0;521;0
33;2021-01-13;116;0;637;0
33;2021-01-14;126;0;763;0
33;2021-01-15;146;0;909;0
33;2021-01-16;43;2;952;2
33;2021-01-17;19;0;971;2
33;2021-01-18;107;0;1078;2
33;2021-01-19;173;0;1251;2
33;2021-01-20;180;0;1431;2
33;2021-01-21;151;0;1582;2
33;2021-01-22;109;1;1691;3
33;2021-01-23;31;0;1722;3
33;2021-01-24;23;0;1745;3
33;2021-01-25;119;2;1864;5
33;2021-01-26;101;17;1965;22
33;2021-01-27;121;23;2086;45
33;2021-01-28;136;56;2222;101
33;2021-01-29;105;74;2327;175
33;2021-01-30;34;28;2361;203
33;2021-01-31;19;23;2380;226
33;2021-02-01;77;74;2457;300
33;2021-02-02;109;78;2566;378
33;2021-02-03;159;74;2725;452
33;2021-02-04;204;130;2929;582
33;2021-02-05;131;111;3060;693
33;2021-02-06;30;22;3090;715
33;2021-02-07;7;10;3097;725
33;2021-02-08;65;73;3162;798
33;2021-02-09;58;150;3220;948
33;2021-02-10;73;110;3293;1058
33;2021-02-11;78;143;3371;1201
33;2021-02-12;75;87;3446;1288
33;2021-02-13;17;22;3463;1310
33;2021-02-14;2;19;3465;1329
33;2021-02-15;28;103;3493;1432
33;2021-02-16;41;106;3534;1538
33;2021-02-17;37;135;3571;1673
33;2021-02-18;59;124;3630;1797
33;2021-02-19;51;118;3681;1915
33;2021-02-20;8;29;3689;1944
33;2021-02-21;1;19;3690;1963
33;2021-02-22;42;86;3732;2049
33;2021-02-23;86;110;3818;2159
33;2021-02-24;111;149;3929;2308
33;2021-02-25;572;143;4501;2451
33;2021-02-26;984;129;5485;2580
33;2021-02-27;617;35;6102;2615
33;2021-02-28;15;23;6117;2638
33;2021-03-01;339;75;6456;2713
33;2021-03-02;609;93;7065;2806
33;2021-03-03;708;97;7773;2903
33;2021-03-04;1055;94;8828;2997
33;2021-03-05;1465;91;10293;3088
33;2021-03-06;883;33;11176;3121
33;2021-03-07;61;5;11237;3126
33;2021-03-08;356;41;11593;3167
33;2021-03-09;732;57;12325;3224
33;2021-03-10;706;61;13031;3285
33;2021-03-11;1241;66;14272;3351
33;2021-03-12;1650;69;15922;3420
33;2021-03-13;812;14;16734;3434
33;2021-03-14;52;0;16786;3434
33;2021-03-15;421;32;17207;3466
33;2021-03-16;254;68;17461;3534
33;2021-03-17;238;77;17699;3611
33;2021-03-18;253;93;17952;3704
33;2021-03-19;688;59;18640;3763
33;2021-03-20;433;7;19073;3770
33;2021-03-21;21;3;19094;3773
33;2021-03-22;500;29;19594;3802
33;2021-03-23;710;32;20304;3834
33;2021-03-24;860;28;21164;3862
33;2021-03-25;1106;39;22270;3901
33;2021-03-26;1322;39;23592;3940
33;2021-03-27;537;2;24129;3942
33;2021-03-28;26;3;24155;3945
33;2021-03-29;734;45;24889;3990
33;2021-03-30;895;52;25784;4042
33;2021-03-31;919;67;26703;4109
33;2021-04-01;1066;70;27769;4179
34;2020-12-28;0;0;0;0
34;2020-12-29;0;0;0;0
34;2020-12-30;0;0;0;0
34;2020-12-31;0;0;0;0
34;2021-01-01;0;0;0;0
34;2021-01-02;0;0;0;0
34;2021-01-03;0;0;0;0
34;2021-01-04;0;0;0;0
34;2021-01-05;13;0;13;0
34;2021-01-06;20;0;33;0
34;2021-01-07;43;0;76;0
34;2021-01-08;76;0;152;0
34;2021-01-09;28;0;180;0
34;2021-01-10;8;0;188;0
34;2021-01-11;81;0;269;0
34;2021-01-12;110;0;379;0
34;2021-01-13;132;0;511;0
34;2021-01-14;178;0;689;0
34;2021-01-15;127;0;816;0
34;2021-01-16;35;1;851;1
34;2021-01-17;25;0;876;1
34;2021-01-18;80;0;956;1
34;2021-01-19;93;0;1049;1
34;2021-01-20;147;0;1196;1
34;2021-01-21;198;0;1394;1
34;2021-01-22;144;0;1538;1
34;2021-01-23;35;0;1573;1
34;2021-01-24;0;0;1573;1
34;2021-01-25;59;0;1632;1
34;2021-01-26;54;1;1686;2
34;2021-01-27;75;0;1761;2
34;2021-01-28;85;15;1846;17
34;2021-01-29;63;25;1909;42
34;2021-01-30;23;1;1932;43
34;2021-01-31;0;0;1932;43
34;2021-02-01;46;41;1978;84
34;2021-02-02;62;69;2040;153
34;2021-02-03;133;62;2173;215
34;2021-02-04;99;107;2272;322
34;2021-02-05;107;117;2379;439
34;2021-02-06;26;18;2405;457
34;2021-02-07;1;9;2406;466
34;2021-02-08;60;79;2466;545
34;2021-02-09;60;92;2526;637
34;2021-02-10;56;143;2582;780
34;2021-02-11;90;212;2672;992
34;2021-02-12;140;126;2812;1118
34;2021-02-13;24;47;2836;1165
34;2021-02-14;2;29;2838;1194
34;2021-02-15;42;68;2880;1262
34;2021-02-16;27;87;2907;1349
34;2021-02-17;46;89;2953;1438
34;2021-02-18;44;73;2997;1511
34;2021-02-19;49;58;3046;1569
34;2021-02-20;14;26;3060;1595
34;2021-02-21;4;0;3064;1595
34;2021-02-22;42;66;3106;1661
34;2021-02-23;31;68;3137;1729
34;2021-02-24;38;112;3175;1841
34;2021-02-25;316;106;3491;1947
34;2021-02-26;473;86;3964;2033
34;2021-02-27;219;23;4183;2056
34;2021-02-28;11;0;4194;2056
34;2021-03-01;184;60;4378;2116
34;2021-03-02;367;55;4745;2171
34;2021-03-03;331;74;5076;2245
34;2021-03-04;581;98;5657;2343
34;2021-03-05;819;81;6476;2424
34;2021-03-06;491;15;6967;2439
34;2021-03-07;149;1;7116;2440
34;2021-03-08;315;55;7431;2495
34;2021-03-09;552;73;7983;2568
34;2021-03-10;505;72;8488;2640
34;2021-03-11;655;65;9143;2705
34;2021-03-12;895;50;10038;2755
34;2021-03-13;397;6;10435;2761
34;2021-03-14;86;0;10521;2761
34;2021-03-15;310;16;10831;2777
34;2021-03-16;185;17;11016;2794
34;2021-03-17;201;42;11217;2836
34;2021-03-18;237;47;11454;2883
34;2021-03-19;442;48;11896;2931
34;2021-03-20;358;1;12254;2932
34;2021-03-21;191;0;12445;2932
34;2021-03-22;328;26;12773;2958
34;2021-03-23;545;22;13318;2980
34;2021-03-24;537;16;13855;2996
34;2021-03-25;792;32;14647;3028
34;2021-03-26;878;34;15525;3062
34;2021-03-27;245;1;15770;3063
34;2021-03-28;36;0;15806;3063
34;2021-03-29;453;34;16259;3097
34;2021-03-30;537;45;16796;3142
34;2021-03-31;546;49;17342;3191
34;2021-04-01;692;47;18034;3238
35;2020-12-28;0;0;0;0
35;2020-12-29;0;0;0;0
35;2020-12-30;0;0;0;0
35;2020-12-31;0;0;0;0
35;2021-01-01;1;0;1;0
35;2021-01-02;0;0;1;0
35;2021-01-03;0;0;1;0
35;2021-01-04;1;0;2;0
35;2021-01-05;6;0;8;0
35;2021-01-06;17;0;25;0
35;2021-01-07;47;0;72;0
35;2021-01-08;66;0;138;0
35;2021-01-09;4;0;142;0
35;2021-01-10;0;0;142;0
35;2021-01-11;51;0;193;0
35;2021-01-12;103;0;296;0
35;2021-01-13;84;0;380;0
35;2021-01-14;116;0;496;0
35;2021-01-15;78;0;574;0
35;2021-01-16;22;3;596;3
35;2021-01-17;1;0;597;3
35;2021-01-18;49;0;646;3
35;2021-01-19;204;0;850;3
35;2021-01-20;122;0;972;3
35;2021-01-21;142;0;1114;3
35;2021-01-22;127;0;1241;3
35;2021-01-23;12;0;1253;3
35;2021-01-24;0;0;1253;3
35;2021-01-25;42;1;1295;4
35;2021-01-26;78;19;1373;23
35;2021-01-27;61;15;1434;38
35;2021-01-28;57;30;1491;68
35;2021-01-29;28;40;1519;108
35;2021-01-30;1;5;1520;113
35;2021-01-31;0;0;1520;113
35;2021-02-01;37;26;1557;139
35;2021-02-02;27;52;1584;191
35;2021-02-03;25;50;1609;241
35;2021-02-04;32;47;1641;288
35;2021-02-05;32;66;1673;354
35;2021-02-06;14;0;1687;354
35;2021-02-07;0;0;1687;354
35;2021-02-08;23;52;1710;406
35;2021-02-09;80;181;1790;587
35;2021-02-10;57;140;1847;727
35;2021-02-11;122;156;1969;883
35;2021-02-12;98;136;2067;1019
35;2021-02-13;1;17;2068;1036
35;2021-02-14;1;0;2069;1036
35;2021-02-15;100;30;2169;1066
35;2021-02-16;90;44;2259;1110
35;2021-02-17;49;43;2308;1153
35;2021-02-18;84;43;2392;1196
35;2021-02-19;71;38;2463;1234
35;2021-02-20;9;3;2472;1237
35;2021-02-21;0;0;2472;1237
35;2021-02-22;56;59;2528;1296
35;2021-02-23;97;32;2625;1328
35;2021-02-24;142;40;2767;1368
35;2021-02-25;568;51;3335;1419
35;2021-02-26;747;31;4082;1450
35;2021-02-27;320;1;4402;1451
35;2021-02-28;0;0;4402;1451
35;2021-03-01;181;29;4583;1480
35;2021-03-02;271;126;4854;1606
35;2021-03-03;371;51;5225;1657
35;2021-03-04;553;92;5778;1749
35;2021-03-05;814;94;6592;1843
35;2021-03-06;415;3;7007;1846
35;2021-03-07;0;0;7007;1846
35;2021-03-08;166;25;7173;1871
35;2021-03-09;438;13;7611;1884
35;2021-03-10;364;23;7975;1907
35;2021-03-11;644;53;8619;1960
35;2021-03-12;1044;35;9663;1995
35;2021-03-13;530;0;10193;1995
35;2021-03-14;3;0;10196;1995
35;2021-03-15;172;97;10368;2092
35;2021-03-16;146;75;10514;2167
35;2021-03-17;149;56;10663;2223
35;2021-03-18;132;61;10795;2284
35;2021-03-19;420;27;11215;2311
35;2021-03-20;297;6;11512;2317
35;2021-03-21;3;0;11515;2317
35;2021-03-22;184;84;11699;2401
35;2021-03-23;382;97;12081;2498
35;2021-03-24;470;88;12551;2586
35;2021-03-25;590;68;13141;2654
35;2021-03-26;789;38;13930;2692
35;2021-03-27;238;5;14168;2697
35;2021-03-28;0;0;14168;2697
35;2021-03-29;309;73;14477;2770
35;2021-03-30;450;74;14927;2844
35;2021-03-31;338;84;15265;2928
35;2021-04-01;431;52;15696;2980
36;2020-12-28;0;0;0;0
36;2020-12-29;0;0;0;0
36;2020-12-30;0;0;0;0
36;2020-12-31;0;0;0;0
36;2021-01-01;0;0;0;0
36;2021-01-02;0;0;0;0
36;2021-01-03;0;0;0;0
36;2021-01-04;0;0;0;0
36;2021-01-05;0;0;0;0
36;2021-01-06;3;0;3;0
36;2021-01-07;8;0;11;0
36;2021-01-08;14;0;25;0
36;2021-01-09;11;0;36;0
36;2021-01-10;13;0;49;0
36;2021-01-11;22;0;71;0
36;2021-01-12;24;0;95;0
36;2021-01-13;18;0;113;0
36;2021-01-14;52;0;165;0
36;2021-01-15;19;0;184;0
36;2021-01-16;2;0;186;0
36;2021-01-17;0;0;186;0
36;2021-01-18;20;0;206;0
36;2021-01-19;54;0;260;0
36;2021-01-20;57;0;317;0
36;2021-01-21;33;0;350;0
36;2021-01-22;28;0;378;0
36;2021-01-23;15;0;393;0
36;2021-01-24;10;0;403;0
36;2021-01-25;30;1;433;1
36;2021-01-26;15;0;448;1
36;2021-01-27;18;2;466;3
36;2021-01-28;14;10;480;13
36;2021-01-29;20;10;500;23
36;2021-01-30;7;8;507;31
36;2021-01-31;8;16;515;47
36;2021-02-01;12;15;527;62
36;2021-02-02;23;19;550;81
36;2021-02-03;16;18;566;99
36;2021-02-04;17;26;583;125
36;2021-02-05;15;12;598;137
36;2021-02-06;0;0;598;137
36;2021-02-07;0;0;598;137
36;2021-02-08;8;13;606;150
36;2021-02-09;14;41;620;191
36;2021-02-10;18;30;638;221
36;2021-02-11;27;47;665;268
36;2021-02-12;23;20;688;288
36;2021-02-13;3;1;691;289
36;2021-02-14;1;4;692;293
36;2021-02-15;0;31;692;324
36;2021-02-16;4;21;696;345
36;2021-02-17;15;24;711;369
36;2021-02-18;22;12;733;381
36;2021-02-19;27;22;760;403
36;2021-02-20;7;19;767;422
36;2021-02-21;9;3;776;425
36;2021-02-22;5;15;781;440
36;2021-02-23;5;19;786;459
36;2021-02-24;8;17;794;476
36;2021-02-25;95;13;889;489
36;2021-02-26;156;16;1045;505
36;2021-02-27;23;12;1068;517
36;2021-02-28;0;3;1068;520
36;2021-03-01;44;17;1112;537
36;2021-03-02;54;14;1166;551
36;2021-03-03;77;27;1243;578
36;2021-03-04;104;22;1347;600
36;2021-03-05;223;11;1570;611
36;2021-03-06;66;0;1636;611
36;2021-03-07;48;0;1684;611
36;2021-03-08;49;8;1733;619
36;2021-03-09;112;7;1845;626
36;2021-03-10;81;19;1926;645
36;2021-03-11;103;23;2029;668
36;2021-03-12;213;30;2242;698
36;2021-03-13;101;3;2343;701
36;2021-03-14;14;0;2357;701
36;2021-03-15;46;4;2403;705
36;2021-03-16;17;3;2420;708
36;2021-03-17;38;4;2458;712
36;2021-03-18;14;17;2472;729
36;2021-03-19;57;9;2529;738
36;2021-03-20;70;1;2599;739
36;2021-03-21;0;0;2599;739
36;2021-03-22;41;6;2640;745
36;2021-03-23;83;2;2723;747
36;2021-03-24;116;3;2839;750
36;2021-03-25;151;11;2990;761
36;2021-03-26;155;3;3145;764
36;2021-03-27;43;4;3188;768
36;2021-03-28;4;2;3192;770
36;2021-03-29;47;16;3239;786
36;2021-03-30;38;9;3277;795
36;2021-03-31;105;9;3382;804
36;2021-04-01;104;19;3486;823
37;2020-12-28;0;0;0;0
37;2020-12-29;1;0;1;0
37;2020-12-30;0;0;1;0
37;2020-12-31;0;0;1;0
37;2021-01-01;0;0;1;0
37;2021-01-02;0;0;1;0
37;2021-01-03;0;0;1;0
37;2021-01-04;0;0;1;0
37;2021-01-05;2;0;3;0
37;2021-01-06;7;0;10;0
37;2021-01-07;16;0;26;0
37;2021-01-08;28;0;54;0
37;2021-01-09;11;0;65;0
37;2021-01-10;7;0;72;0
37;2021-01-11;36;0;108;0
37;2021-01-12;56;0;164;0
37;2021-01-13;49;0;213;0
37;2021-01-14;41;0;254;0
37;2021-01-15;71;0;325;0
37;2021-01-16;33;0;358;0
37;2021-01-17;30;0;388;0
37;2021-01-18;49;0;437;0
37;2021-01-19;82;1;519;1
37;2021-01-20;71;0;590;1
37;2021-01-21;70;0;660;1
37;2021-01-22;66;0;726;1
37;2021-01-23;9;0;735;1
37;2021-01-24;0;0;735;1
37;2021-01-25;42;2;777;3
37;2021-01-26;98;5;875;8
37;2021-01-27;85;8;960;16
37;2021-01-28;86;13;1046;29
37;2021-01-29;64;18;1110;47
37;2021-01-30;9;7;1119;54
37;2021-01-31;1;5;1120;59
37;2021-02-01;33;29;1153;88
37;2021-02-02;42;48;1195;136
37;2021-02-03;47;38;1242;174
37;2021-02-04;42;44;1284;218
37;2021-02-05;41;43;1325;261
37;2021-02-06;7;0;1332;261
37;2021-02-07;2;0;1334;261
37;2021-02-08;32;28;1366;289
37;2021-02-09;50;45;1416;334
37;2021-02-10;50;59;1466;393
37;2021-02-11;44;51;1510;444
37;2021-02-12;44;41;1554;485
37;2021-02-13;8;21;1562;506
37;2021-02-14;0;9;1562;515
37;2021-02-15;28;65;1590;580
37;2021-02-16;45;98;1635;678
37;2021-02-17;35;74;1670;752
37;2021-02-18;66;81;1736;833
37;2021-02-19;57;68;1793;901
37;2021-02-20;7;7;1800;908
37;2021-02-21;1;0;1801;908
37;2021-02-22;38;51;1839;959
37;2021-02-23;28;41;1867;1000
37;2021-02-24;74;50;1941;1050
37;2021-02-25;208;55;2149;1105
37;2021-02-26;373;73;2522;1178
37;2021-02-27;247;5;2769;1183
37;2021-02-28;7;0;2776;1183
37;2021-03-01;95;23;2871;1206
37;2021-03-02;191;33;3062;1239
37;2021-03-03;194;37;3256;1276
37;2021-03-04;313;26;3569;1302
37;2021-03-05;462;33;4031;1335
37;2021-03-06;274;3;4305;1338
37;2021-03-07;18;0;4323;1338
37;2021-03-08;114;31;4437;1369
37;2021-03-09;261;42;4698;1411
37;2021-03-10;235;48;4933;1459
37;2021-03-11;287;51;5220;1510
37;2021-03-12;504;42;5724;1552
37;2021-03-13;442;6;6166;1558
37;2021-03-14;29;0;6195;1558
37;2021-03-15;106;15;6301;1573
37;2021-03-16;57;17;6358;1590
37;2021-03-17;68;23;6426;1613
37;2021-03-18;55;41;6481;1654
37;2021-03-19;225;47;6706;1701
37;2021-03-20;227;1;6933;1702
37;2021-03-21;29;0;6962;1702
37;2021-03-22;106;38;7068;1740
37;2021-03-23;238;31;7306;1771
37;2021-03-24;234;55;7540;1826
37;2021-03-25;307;41;7847;1867
37;2021-03-26;398;39;8245;1906
37;2021-03-27;161;4;8406;1910
37;2021-03-28;33;0;8439;1910
37;2021-03-29;110;30;8549;1940
37;2021-03-30;239;34;8788;1974
37;2021-03-31;153;29;8941;2003
37;2021-04-01;254;33;9195;2036
38;2020-12-28;0;0;0;0
38;2020-12-29;0;0;0;0
38;2020-12-30;0;0;0;0
38;2020-12-31;0;0;0;0
38;2021-01-01;0;0;0;0
38;2021-01-02;0;0;0;0
38;2021-01-03;0;0;0;0
38;2021-01-04;11;0;11;0
38;2021-01-05;20;0;31;0
38;2021-01-06;31;0;62;0
38;2021-01-07;60;0;122;0
38;2021-01-08;70;0;192;0
38;2021-01-09;9;0;201;0
38;2021-01-10;0;0;201;0
38;2021-01-11;84;0;285;0
38;2021-01-12;117;0;402;0
38;2021-01-13;82;0;484;0
38;2021-01-14;108;0;592;0
38;2021-01-15;122;0;714;0
38;2021-01-16;27;0;741;0
38;2021-01-17;0;0;741;0
38;2021-01-18;61;0;802;0
38;2021-01-19;109;0;911;0
38;2021-01-20;71;0;982;0
38;2021-01-21;94;0;1076;0
38;2021-01-22;88;1;1164;1
38;2021-01-23;10;0;1174;1
38;2021-01-24;0;0;1174;1
38;2021-01-25;32;14;1206;15
38;2021-01-26;43;20;1249;35
38;2021-01-27;32;27;1281;62
38;2021-01-28;52;44;1333;106
38;2021-01-29;49;39;1382;145
38;2021-01-30;8;0;1390;145
38;2021-01-31;0;0;1390;145
38;2021-02-01;45;56;1435;201
38;2021-02-02;49;92;1484;293
38;2021-02-03;72;63;1556;356
38;2021-02-04;105;86;1661;442
38;2021-02-05;92;87;1753;529
38;2021-02-06;9;6;1762;535
38;2021-02-07;0;0;1762;535
38;2021-02-08;43;46;1805;581
38;2021-02-09;132;80;1937;661
38;2021-02-10;124;66;2061;727
38;2021-02-11;151;63;2212;790
38;2021-02-12;113;66;2325;856
38;2021-02-13;29;9;2354;865
38;2021-02-14;0;0;2354;865
38;2021-02-15;54;42;2408;907
38;2021-02-16;72;66;2480;973
38;2021-02-17;105;63;2585;1036
38;2021-02-18;114;77;2699;1113
38;2021-02-19;86;71;2785;1184
38;2021-02-20;11;13;2796;1197
38;2021-02-21;0;0;2796;1197
38;2021-02-22;60;40;2856;1237
38;2021-02-23;94;45;2950;1282
38;2021-02-24;103;43;3053;1325
38;2021-02-25;334;58;3387;1383
38;2021-02-26;709;49;4096;1432
38;2021-02-27;334;10;4430;1442
38;2021-02-28;11;0;4441;1442
38;2021-03-01;283;59;4724;1501
38;2021-03-02;668;64;5392;1565
38;2021-03-03;539;56;5931;1621
38;2021-03-04;890;105;6821;1726
38;2021-03-05;1138;88;7959;1814
38;2021-03-06;564;2;8523;1816
38;2021-03-07;22;0;8545;1816
38;2021-03-08;282;33;8827;1849
38;2021-03-09;581;74;9408;1923
38;2021-03-10;474;78;9882;2001
38;2021-03-11;796;105;10678;2106
38;2021-03-12;1193;89;11871;2195
38;2021-03-13;615;3;12486;2198
38;2021-03-14;57;0;12543;2198
38;2021-03-15;282;50;12825;2248
38;2021-03-16;127;72;12952;2320
38;2021-03-17;145;66;13097;2386
38;2021-03-18;180;65;13277;2451
38;2021-03-19;458;70;13735;2521
38;2021-03-20;250;3;13985;2524
38;2021-03-21;26;0;14011;2524
38;2021-03-22;326;52;14337;2576
38;2021-03-23;593;94;14930;2670
38;2021-03-24;451;96;15381;2766
38;2021-03-25;750;89;16131;2855
38;2021-03-26;919;79;17050;2934
38;2021-03-27;377;21;17427;2955
38;2021-03-28;61;0;17488;2955
38;2021-03-29;353;91;17841;3046
38;2021-03-30;620;144;18461;3190
38;2021-03-31;410;92;18871;3282
38;2021-04-01;518;119;19389;3401
39;2020-12-28;0;0;0;0
39;2020-12-29;0;0;0;0
39;2020-12-30;0;0;0;0
39;2020-12-31;0;0;0;0
39;2021-01-01;0;0;0;0
39;2021-01-02;0;0;0;0
39;2021-01-03;0;0;0;0
39;2021-01-04;0;0;0;0
39;2021-01-05;0;0;0;0
39;2021-01-06;0;0;0;0
39;2021-01-07;22;0;22;0
39;2021-01-08;68;0;90;0
39;2021-01-09;21;0;111;0
39;2021-01-10;0;0;111;0
39;2021-01-11;46;0;157;0
39;2021-01-12;41;0;198;0
39;2021-01-13;51;0;249;0
39;2021-01-14;41;0;290;0
39;2021-01-15;35;0;325;0
39;2021-01-16;10;1;335;1
39;2021-01-17;0;0;335;1
39;2021-01-18;35;0;370;1
39;2021-01-19;49;0;419;1
39;2021-01-20;47;0;466;1
39;2021-01-21;58;0;524;1
39;2021-01-22;55;0;579;1
39;2021-01-23;15;0;594;1
39;2021-01-24;0;0;594;1
39;2021-01-25;29;0;623;1
39;2021-01-26;33;2;656;3
39;2021-01-27;38;0;694;3
39;2021-01-28;36;26;730;29
39;2021-01-29;34;43;764;72
39;2021-01-30;11;12;775;84
39;2021-01-31;0;0;775;84
39;2021-02-01;25;26;800;110
39;2021-02-02;36;28;836;138
39;2021-02-03;30;50;866;188
39;2021-02-04;29;45;895;233
39;2021-02-05;18;29;913;262
39;2021-02-06;10;9;923;271
39;2021-02-07;0;0;923;271
39;2021-02-08;23;25;946;296
39;2021-02-09;20;23;966;319
39;2021-02-10;11;34;977;353
39;2021-02-11;36;42;1013;395
39;2021-02-12;32;30;1045;425
39;2021-02-13;9;5;1054;430
39;2021-02-14;0;0;1054;430
39;2021-02-15;9;30;1063;460
39;2021-02-16;5;27;1068;487
39;2021-02-17;2;26;1070;513
39;2021-02-18;11;41;1081;554
39;2021-02-19;4;26;1085;580
39;2021-02-20;1;10;1086;590
39;2021-02-21;0;0;1086;590
39;2021-02-22;5;31;1091;621
39;2021-02-23;0;25;1091;646
39;2021-02-24;35;42;1126;688
39;2021-02-25;83;38;1209;726
39;2021-02-26;96;24;1305;750
39;2021-02-27;61;14;1366;764
39;2021-02-28;0;0;1366;764
39;2021-03-01;52;26;1418;790
39;2021-03-02;85;38;1503;828
39;2021-03-03;128;22;1631;850
39;2021-03-04;118;42;1749;892
39;2021-03-05;133;16;1882;908
39;2021-03-06;156;10;2038;918
39;2021-03-07;28;0;2066;918
39;2021-03-08;24;24;2090;942
39;2021-03-09;141;25;2231;967
39;2021-03-10;170;18;2401;985
39;2021-03-11;150;20;2551;1005
39;2021-03-12;152;14;2703;1019
39;2021-03-13;126;10;2829;1029
39;2021-03-14;5;0;2834;1029
39;2021-03-15;42;4;2876;1033
39;2021-03-16;71;3;2947;1036
39;2021-03-17;62;5;3009;1041
39;2021-03-18;31;2;3040;1043
39;2021-03-19;68;3;3108;1046
39;2021-03-20;56;0;3164;1046
39;2021-03-21;0;0;3164;1046
39;2021-03-22;69;1;3233;1047
39;2021-03-23;153;1;3386;1048
39;2021-03-24;157;6;3543;1054
39;2021-03-25;281;1;3824;1055
39;2021-03-26;108;20;3932;1075
39;2021-03-27;45;0;3977;1075
39;2021-03-28;7;0;3984;1075
39;2021-03-29;156;15;4140;1090
39;2021-03-30;182;7;4322;1097
39;2021-03-31;101;50;4423;1147
39;2021-04-01;133;21;4556;1168
40;2020-12-28;0;0;0;0
40;2020-12-29;0;0;0;0
40;2020-12-30;0;0;0;0
40;2020-12-31;0;0;0;0
40;2021-01-01;0;0;0;0
40;2021-01-02;0;0;0;0
40;2021-01-03;0;0;0;0
40;2021-01-04;0;0;0;0
40;2021-01-05;0;0;0;0
40;2021-01-06;0;0;0;0
40;2021-01-07;25;0;25;0
40;2021-01-08;30;0;55;0
40;2021-01-09;0;0;55;0
40;2021-01-10;0;0;55;0
40;2021-01-11;15;0;70;0
40;2021-01-12;0;0;70;0
40;2021-01-13;53;0;123;0
40;2021-01-14;73;0;196;0
40;2021-01-15;56;0;252;0
40;2021-01-16;2;1;254;1
40;2021-01-17;0;0;254;1
40;2021-01-18;17;0;271;1
40;2021-01-19;45;0;316;1
40;2021-01-20;48;0;364;1
40;2021-01-21;65;0;429;1
40;2021-01-22;59;0;488;1
40;2021-01-23;18;0;506;1
40;2021-01-24;0;0;506;1
40;2021-01-25;14;0;520;1
40;2021-01-26;49;0;569;1
40;2021-01-27;50;3;619;4
40;2021-01-28;42;17;661;21
40;2021-01-29;29;22;690;43
40;2021-01-30;15;3;705;46
40;2021-01-31;0;0;705;46
40;2021-02-01;32;16;737;62
40;2021-02-02;53;5;790;67
40;2021-02-03;28;33;818;100
40;2021-02-04;50;52;868;152
40;2021-02-05;39;25;907;177
40;2021-02-06;35;1;942;178
40;2021-02-07;0;0;942;178
40;2021-02-08;19;17;961;195
40;2021-02-09;37;28;998;223
40;2021-02-10;33;35;1031;258
40;2021-02-11;37;67;1068;325
40;2021-02-12;33;40;1101;365
40;2021-02-13;21;3;1122;368
40;2021-02-14;0;0;1122;368
40;2021-02-15;7;16;1129;384
40;2021-02-16;16;28;1145;412
40;2021-02-17;32;44;1177;456
40;2021-02-18;23;62;1200;518
40;2021-02-19;14;25;1214;543
40;2021-02-20;12;7;1226;550
40;2021-02-21;0;2;1226;552
40;2021-02-22;6;14;1232;566
40;2021-02-23;12;52;1244;618
40;2021-02-24;15;31;1259;649
40;2021-02-25;152;51;1411;700
40;2021-02-26;223;18;1634;718
40;2021-02-27;183;6;1817;724
40;2021-02-28;0;0;1817;724
40;2021-03-01;91;35;1908;759
40;2021-03-02;185;54;2093;813
40;2021-03-03;251;35;2344;848
40;2021-03-04;374;59;2718;907
40;2021-03-05;379;29;3097;936
40;2021-03-06;229;23;3326;959
40;2021-03-07;2;0;3328;959
40;2021-03-08;104;26;3432;985
40;2021-03-09;228;23;3660;1008
40;2021-03-10;242;32;3902;1040
40;2021-03-11;337;35;4239;1075
40;2021-03-12;342;27;4581;1102
40;2021-03-13;180;11;4761;1113
40;2021-03-14;11;0;4772;1113
40;2021-03-15;77;5;4849;1118
40;2021-03-16;40;14;4889;1132
40;2021-03-17;75;15;4964;1147
40;2021-03-18;80;16;5044;1163
40;2021-03-19;182;10;5226;1173
40;2021-03-20;83;0;5309;1173
40;2021-03-21;8;0;5317;1173
40;2021-03-22;129;2;5446;1175
40;2021-03-23;239;7;5685;1182
40;2021-03-24;206;4;5891;1186
40;2021-03-25;297;16;6188;1202
40;2021-03-26;363;12;6551;1214
40;2021-03-27;122;1;6673;1215
40;2021-03-28;13;0;6686;1215
40;2021-03-29;123;20;6809;1235
40;2021-03-30;247;22;7056;1257
40;2021-03-31;213;8;7269;1265
40;2021-04-01;217;26;7486;1291
41;2020-12-28;0;0;0;0
41;2020-12-29;0;0;0;0
41;2020-12-30;0;0;0;0
41;2020-12-31;0;0;0;0
41;2021-01-01;0;0;0;0
41;2021-01-02;0;0;0;0
41;2021-01-03;0;0;0;0
41;2021-01-04;0;0;0;0
41;2021-01-05;1;0;1;0
41;2021-01-06;1;0;2;0
41;2021-01-07;0;0;2;0
41;2021-01-08;0;0;2;0
41;2021-01-09;0;0;2;0
41;2021-01-10;0;0;2;0
41;2021-01-11;15;0;17;0
41;2021-01-12;37;0;54;0
41;2021-01-13;23;0;77;0
41;2021-01-14;34;0;111;0
41;2021-01-15;34;0;145;0
41;2021-01-16;0;0;145;0
41;2021-01-17;0;0;145;0
41;2021-01-18;50;0;195;0
41;2021-01-19;53;0;248;0
41;2021-01-20;64;0;312;0
41;2021-01-21;78;0;390;0
41;2021-01-22;50;0;440;0
41;2021-01-23;0;0;440;0
41;2021-01-24;0;0;440;0
41;2021-01-25;28;0;468;0
41;2021-01-26;38;0;506;0
41;2021-01-27;23;1;529;1
41;2021-01-28;34;1;563;2
41;2021-01-29;7;0;570;2
41;2021-01-30;0;0;570;2
41;2021-01-31;0;0;570;2
41;2021-02-01;32;18;602;20
41;2021-02-02;33;31;635;51
41;2021-02-03;24;19;659;70
41;2021-02-04;30;24;689;94
41;2021-02-05;25;37;714;131
41;2021-02-06;0;0;714;131
41;2021-02-07;0;0;714;131
41;2021-02-08;19;40;733;171
41;2021-02-09;55;26;788;197
41;2021-02-10;46;65;834;262
41;2021-02-11;68;65;902;327
41;2021-02-12;27;25;929;352
41;2021-02-13;0;0;929;352
41;2021-02-14;0;0;929;352
41;2021-02-15;17;26;946;378
41;2021-02-16;40;30;986;408
41;2021-02-17;22;33;1008;441
41;2021-02-18;41;34;1049;475
41;2021-02-19;29;26;1078;501
41;2021-02-20;2;1;1080;502
41;2021-02-21;0;0;1080;502
41;2021-02-22;14;39;1094;541
41;2021-02-23;19;20;1113;561
41;2021-02-24;9;17;1122;578
41;2021-02-25;128;29;1250;607
41;2021-02-26;190;8;1440;615
41;2021-02-27;69;0;1509;615
41;2021-02-28;0;0;1509;615
41;2021-03-01;14;23;1523;638
41;2021-03-02;63;35;1586;673
41;2021-03-03;89;35;1675;708
41;2021-03-04;153;57;1828;765
41;2021-03-05;185;33;2013;798
41;2021-03-06;147;0;2160;798
41;2021-03-07;48;0;2208;798
41;2021-03-08;27;18;2235;816
41;2021-03-09;86;47;2321;863
41;2021-03-10;110;37;2431;900
41;2021-03-11;149;46;2580;946
41;2021-03-12;178;29;2758;975
41;2021-03-13;275;0;3033;975
41;2021-03-14;31;0;3064;975
41;2021-03-15;43;20;3107;995
41;2021-03-16;47;25;3154;1020
41;2021-03-17;37;15;3191;1035
41;2021-03-18;40;21;3231;1056
41;2021-03-19;86;15;3317;1071
41;2021-03-20;92;0;3409;1071
41;2021-03-21;0;0;3409;1071
41;2021-03-22;66;14;3475;1085
41;2021-03-23;123;8;3598;1093
41;2021-03-24;173;14;3771;1107
41;2021-03-25;216;16;3987;1123
41;2021-03-26;172;9;4159;1132
41;2021-03-27;50;3;4209;1135
41;2021-03-28;0;0;4209;1135
41;2021-03-29;93;18;4302;1153
41;2021-03-30;153;29;4455;1182
41;2021-03-31;119;30;4574;1212
41;2021-04-01;210;29;4784;1241
42;2020-12-28;0;0;0;0
42;2020-12-29;0;0;0;0
42;2020-12-30;0;0;0;0
42;2020-12-31;0;0;0;0
42;2021-01-01;0;0;0;0
42;2021-01-02;0;0;0;0
42;2021-01-03;0;0;0;0
42;2021-01-04;0;0;0;0
42;2021-01-05;0;0;0;0
42;2021-01-06;24;0;24;0
42;2021-01-07;32;0;56;0
42;2021-01-08;35;0;91;0
42;2021-01-09;22;0;113;0
42;2021-01-10;0;0;113;0
42;2021-01-11;40;0;153;0
42;2021-01-12;59;0;212;0
42;2021-01-13;58;0;270;0
42;2021-01-14;77;0;347;0
42;2021-01-15;73;0;420;0
42;2021-01-16;45;0;465;0
42;2021-01-17;17;0;482;0
42;2021-01-18;43;0;525;0
42;2021-01-19;52;0;577;0
42;2021-01-20;45;0;622;0
42;2021-01-21;34;0;656;0
42;2021-01-22;47;0;703;0
42;2021-01-23;12;0;715;0
42;2021-01-24;3;0;718;0
42;2021-01-25;40;1;758;1
42;2021-01-26;51;2;809;3
42;2021-01-27;73;17;882;20
42;2021-01-28;75;13;957;33
42;2021-01-29;53;20;1010;53
42;2021-01-30;6;19;1016;72
42;2021-01-31;0;0;1016;72
42;2021-02-01;23;8;1039;80
42;2021-02-02;71;32;1110;112
42;2021-02-03;56;67;1166;179
42;2021-02-04;70;67;1236;246
42;2021-02-05;32;46;1268;292
42;2021-02-06;17;20;1285;312
42;2021-02-07;6;20;1291;332
42;2021-02-08;26;54;1317;386
42;2021-02-09;33;60;1350;446
42;2021-02-10;45;29;1395;475
42;2021-02-11;75;22;1470;497
42;2021-02-12;52;40;1522;537
42;2021-02-13;21;28;1543;565
42;2021-02-14;11;10;1554;575
42;2021-02-15;36;29;1590;604
42;2021-02-16;40;43;1630;647
42;2021-02-17;38;75;1668;722
42;2021-02-18;66;60;1734;782
42;2021-02-19;62;48;1796;830
42;2021-02-20;14;10;1810;840
42;2021-02-21;3;5;1813;845
42;2021-02-22;39;41;1852;886
42;2021-02-23;69;76;1921;962
42;2021-02-24;139;53;2060;1015
42;2021-02-25;247;62;2307;1077
42;2021-02-26;269;33;2576;1110
42;2021-02-27;130;2;2706;1112
42;2021-02-28;9;4;2715;1116
42;2021-03-01;68;28;2783;1144
42;2021-03-02;229;22;3012;1166
42;2021-03-03;300;33;3312;1199
42;2021-03-04;396;23;3708;1222
42;2021-03-05;519;17;4227;1239
42;2021-03-06;313;6;4540;1245
42;2021-03-07;142;0;4682;1245
42;2021-03-08;141;35;4823;1280
42;2021-03-09;301;35;5124;1315
42;2021-03-10;256;44;5380;1359
42;2021-03-11;486;62;5866;1421
42;2021-03-12;430;59;6296;1480
42;2021-03-13;242;11;6538;1491
42;2021-03-14;39;10;6577;1501
42;2021-03-15;183;30;6760;1531
42;2021-03-16;83;39;6843;1570
42;2021-03-17;95;60;6938;1630
42;2021-03-18;113;41;7051;1671
42;2021-03-19;283;35;7334;1706
42;2021-03-20;178;12;7512;1718
42;2021-03-21;28;1;7540;1719
42;2021-03-22;169;24;7709;1743
42;2021-03-23;287;39;7996;1782
42;2021-03-24;316;54;8312;1836
42;2021-03-25;462;44;8774;1880
42;2021-03-26;463;40;9237;1920
42;2021-03-27;228;15;9465;1935
42;2021-03-28;78;11;9543;1946
42;2021-03-29;269;41;9812;1987
42;2021-03-30;394;50;10206;2037
42;2021-03-31;281;56;10487;2093
42;2021-04-01;377;34;10864;2127
43;2020-12-28;0;0;0;0
43;2020-12-29;0;0;0;0
43;2020-12-30;0;0;0;0
43;2020-12-31;0;0;0;0
43;2021-01-01;0;0;0;0
43;2021-01-02;0;0;0;0
43;2021-01-03;0;0;0;0
43;2021-01-04;0;0;0;0
43;2021-01-05;0;0;0;0
43;2021-01-06;0;0;0;0
43;2021-01-07;6;0;6;0
43;2021-01-08;12;0;18;0
43;2021-01-09;0;0;18;0
43;2021-01-10;0;0;18;0
43;2021-01-11;17;0;35;0
43;2021-01-12;21;0;56;0
43;2021-01-13;18;0;74;0
43;2021-01-14;22;0;96;0
43;2021-01-15;31;0;127;0
43;2021-01-16;3;0;130;0
43;2021-01-17;0;0;130;0
43;2021-01-18;19;0;149;0
43;2021-01-19;33;0;182;0
43;2021-01-20;19;0;201;0
43;2021-01-21;20;0;221;0
43;2021-01-22;30;0;251;0
43;2021-01-23;1;0;252;0
43;2021-01-24;1;0;253;0
43;2021-01-25;22;0;275;0
43;2021-01-26;38;0;313;0
43;2021-01-27;41;0;354;0
43;2021-01-28;32;3;386;3
43;2021-01-29;45;7;431;10
43;2021-01-30;8;0;439;10
43;2021-01-31;0;0;439;10
43;2021-02-01;15;17;454;27
43;2021-02-02;29;12;483;39
43;2021-02-03;26;1;509;40
43;2021-02-04;13;9;522;49
43;2021-02-05;25;13;547;62
43;2021-02-06;4;2;551;64
43;2021-02-07;0;0;551;64
43;2021-02-08;17;14;568;78
43;2021-02-09;8;21;576;99
43;2021-02-10;22;20;598;119
43;2021-02-11;27;20;625;139
43;2021-02-12;27;22;652;161
43;2021-02-13;42;0;694;161
43;2021-02-14;0;0;694;161
43;2021-02-15;3;25;697;186
43;2021-02-16;4;19;701;205
43;2021-02-17;8;29;709;234
43;2021-02-18;12;21;721;255
43;2021-02-19;16;30;737;285
43;2021-02-20;1;0;738;285
43;2021-02-21;0;0;738;285
43;2021-02-22;0;22;738;307
43;2021-02-23;19;38;757;345
43;2021-02-24;8;28;765;373
43;2021-02-25;56;23;821;396
43;2021-02-26;91;36;912;432
43;2021-02-27;71;6;983;438
43;2021-02-28;1;0;984;438
43;2021-03-01;25;21;1009;459
43;2021-03-02;86;20;1095;479
43;2021-03-03;63;30;1158;509
43;2021-03-04;88;8;1246;517
43;2021-03-05;132;19;1378;536
43;2021-03-06;101;3;1479;539
43;2021-03-07;3;0;1482;539
43;2021-03-08;52;17;1534;556
43;2021-03-09;55;18;1589;574
43;2021-03-10;77;20;1666;594
43;2021-03-11;117;29;1783;623
43;2021-03-12;143;26;1926;649
43;2021-03-13;148;2;2074;651
43;2021-03-14;0;0;2074;651
43;2021-03-15;51;5;2125;656
43;2021-03-16;50;11;2175;667
43;2021-03-17;23;13;2198;680
43;2021-03-18;26;4;2224;684
43;2021-03-19;91;1;2315;685
43;2021-03-20;70;0;2385;685
43;2021-03-21;0;0;2385;685
43;2021-03-22;66;3;2451;688
43;2021-03-23;106;0;2557;688
43;2021-03-24;141;2;2698;690
43;2021-03-25;221;5;2919;695
43;2021-03-26;190;4;3109;699
43;2021-03-27;189;0;3298;699
43;2021-03-28;52;0;3350;699
43;2021-03-29;107;5;3457;704
43;2021-03-30;168;8;3625;712
43;2021-03-31;146;11;3771;723
43;2021-04-01;164;15;3935;738
44;2020-12-28;0;0;0;0
44;2020-12-29;0;0;0;0
44;2020-12-30;0;0;0;0
44;2020-12-31;0;0;0;0
44;2021-01-01;0;0;0;0
44;2021-01-02;0;0;0;0
44;2021-01-03;0;0;0;0
44;2021-01-04;0;0;0;0
44;2021-01-05;0;0;0;0
44;2021-01-06;7;0;7;0
44;2021-01-07;29;0;36;0
44;2021-01-08;80;0;116;0
44;2021-01-09;62;0;178;0
44;2021-01-10;58;0;236;0
44;2021-01-11;95;0;331;0
44;2021-01-12;109;0;440;0
44;2021-01-13;138;0;578;0
44;2021-01-14;131;0;709;0
44;2021-01-15;107;0;816;0
44;2021-01-16;35;1;851;1
44;2021-01-17;29;0;880;1
44;2021-01-18;50;0;930;1
44;2021-01-19;149;0;1079;1
44;2021-01-20;128;0;1207;1
44;2021-01-21;213;0;1420;1
44;2021-01-22;176;0;1596;1
44;2021-01-23;34;0;1630;1
44;2021-01-24;13;0;1643;1
44;2021-01-25;40;0;1683;1
44;2021-01-26;143;2;1826;3
44;2021-01-27;106;12;1932;15
44;2021-01-28;182;29;2114;44
44;2021-01-29;101;74;2215;118
44;2021-01-30;33;31;2248;149
44;2021-01-31;2;31;2250;180
44;2021-02-01;17;87;2267;267
44;2021-02-02;46;108;2313;375
44;2021-02-03;44;96;2357;471
44;2021-02-04;60;94;2417;565
44;2021-02-05;60;82;2477;647
44;2021-02-06;22;38;2499;685
44;2021-02-07;0;30;2499;715
44;2021-02-08;24;46;2523;761
44;2021-02-09;50;84;2573;845
44;2021-02-10;71;64;2644;909
44;2021-02-11;107;173;2751;1082
44;2021-02-12;97;123;2848;1205
44;2021-02-13;27;41;2875;1246
44;2021-02-14;0;12;2875;1258
44;2021-02-15;30;29;2905;1287
44;2021-02-16;89;140;2994;1427
44;2021-02-17;73;133;3067;1560
44;2021-02-18;142;168;3209;1728
44;2021-02-19;112;168;3321;1896
44;2021-02-20;27;29;3348;1925
44;2021-02-21;0;7;3348;1932
44;2021-02-22;55;27;3403;1959
44;2021-02-23;98;71;3501;2030
44;2021-02-24;162;46;3663;2076
44;2021-02-25;731;59;4394;2135
44;2021-02-26;800;65;5194;2200
44;2021-02-27;387;18;5581;2218
44;2021-02-28;0;0;5581;2218
44;2021-03-01;162;20;5743;2238
44;2021-03-02;351;55;6094;2293
44;2021-03-03;379;75;6473;2368
44;2021-03-04;732;109;7205;2477
44;2021-03-05;887;95;8092;2572
44;2021-03-06;621;25;8713;2597
44;2021-03-07;63;0;8776;2597
44;2021-03-08;234;28;9010;2625
44;2021-03-09;517;58;9527;2683
44;2021-03-10;418;49;9945;2732
44;2021-03-11;718;114;10663;2846
44;2021-03-12;1168;72;11831;2918
44;2021-03-13;670;25;12501;2943
44;2021-03-14;26;1;12527;2944
44;2021-03-15;344;15;12871;2959
44;2021-03-16;149;41;13020;3000
44;2021-03-17;129;41;13149;3041
44;2021-03-18;142;56;13291;3097
44;2021-03-19;428;22;13719;3119
44;2021-03-20;483;10;14202;3129
44;2021-03-21;80;0;14282;3129
44;2021-03-22;255;31;14537;3160
44;2021-03-23;490;73;15027;3233
44;2021-03-24;551;41;15578;3274
44;2021-03-25;749;69;16327;3343
44;2021-03-26;858;63;17185;3406
44;2021-03-27;384;21;17569;3427
44;2021-03-28;75;3;17644;3430
44;2021-03-29;283;41;17927;3471
44;2021-03-30;527;59;18454;3530
44;2021-03-31;439;70;18893;3600
44;2021-04-01;601;67;19494;3667
45;2020-12-28;0;0;0;0
45;2020-12-29;0;0;0;0
45;2020-12-30;0;0;0;0
45;2020-12-31;0;0;0;0
45;2021-01-01;0;0;0;0
45;2021-01-02;0;0;0;0
45;2021-01-03;0;0;0;0
45;2021-01-04;0;0;0;0
45;2021-01-05;2;0;2;0
45;2021-01-06;4;0;6;0
45;2021-01-07;12;0;18;0
45;2021-01-08;23;0;41;0
45;2021-01-09;8;0;49;0
45;2021-01-10;5;0;54;0
45;2021-01-11;34;0;88;0
45;2021-01-12;65;0;153;0
45;2021-01-13;58;0;211;0
45;2021-01-14;48;0;259;0
45;2021-01-15;46;0;305;0
45;2021-01-16;8;3;313;3
45;2021-01-17;4;0;317;3
45;2021-01-18;50;0;367;3
45;2021-01-19;67;0;434;3
45;2021-01-20;115;0;549;3
45;2021-01-21;109;0;658;3
45;2021-01-22;77;0;735;3
45;2021-01-23;7;0;742;3
45;2021-01-24;1;0;743;3
45;2021-01-25;24;0;767;3
45;2021-01-26;40;0;807;3
45;2021-01-27;39;3;846;6
45;2021-01-28;46;17;892;23
45;2021-01-29;20;15;912;38
45;2021-01-30;1;6;913;44
45;2021-01-31;3;6;916;50
45;2021-02-01;9;30;925;80
45;2021-02-02;33;50;958;130
45;2021-02-03;42;49;1000;179
45;2021-02-04;43;31;1043;210
45;2021-02-05;35;15;1078;225
45;2021-02-06;4;3;1082;228
45;2021-02-07;0;6;1082;234
45;2021-02-08;37;13;1119;247
45;2021-02-09;63;25;1182;272
45;2021-02-10;75;38;1257;310
45;2021-02-11;77;69;1334;379
45;2021-02-12;53;75;1387;454
45;2021-02-13;1;5;1388;459
45;2021-02-14;7;0;1395;459
45;2021-02-15;23;35;1418;494
45;2021-02-16;38;67;1456;561
45;2021-02-17;26;57;1482;618
45;2021-02-18;50;59;1532;677
45;2021-02-19;38;51;1570;728
45;2021-02-20;9;4;1579;732
45;2021-02-21;1;3;1580;735
45;2021-02-22;28;29;1608;764
45;2021-02-23;30;35;1638;799
45;2021-02-24;34;34;1672;833
45;2021-02-25;204;34;1876;867
45;2021-02-26;187;22;2063;889
45;2021-02-27;118;0;2181;889
45;2021-02-28;2;0;2183;889
45;2021-03-01;57;17;2240;906
45;2021-03-02;86;33;2326;939
45;2021-03-03;125;59;2451;998
45;2021-03-04;193;58;2644;1056
45;2021-03-05;290;65;2934;1121
45;2021-03-06;295;4;3229;1125
45;2021-03-07;14;1;3243;1126
45;2021-03-08;157;41;3400;1167
45;2021-03-09;182;49;3582;1216
45;2021-03-10;236;57;3818;1273
45;2021-03-11;276;28;4094;1301
45;2021-03-12;313;24;4407;1325
45;2021-03-13;257;2;4664;1327
45;2021-03-14;4;2;4668;1329
45;2021-03-15;112;25;4780;1354
45;2021-03-16;63;34;4843;1388
45;2021-03-17;89;31;4932;1419
45;2021-03-18;77;46;5009;1465
45;2021-03-19;161;18;5170;1483
45;2021-03-20;101;4;5271;1487
45;2021-03-21;4;2;5275;1489
45;2021-03-22;66;26;5341;1515
45;2021-03-23;208;24;5549;1539
45;2021-03-24;230;26;5779;1565
45;2021-03-25;414;10;6193;1575
45;2021-03-26;429;13;6622;1588
45;2021-03-27;243;6;6865;1594
45;2021-03-28;5;2;6870;1596
45;2021-03-29;191;14;7061;1610
45;2021-03-30;292;35;7353;1645
45;2021-03-31;265;17;7618;1662
45;2021-04-01;350;13;7968;1675
46;2020-12-28;0;0;0;0
46;2020-12-29;0;0;0;0
46;2020-12-30;0;0;0;0
46;2020-12-31;0;0;0;0
46;2021-01-01;0;0;0;0
46;2021-01-02;0;0;0;0
46;2021-01-03;0;0;0;0
46;2021-01-04;0;0;0;0
46;2021-01-05;0;0;0;0
46;2021-01-06;0;0;0;0
46;2021-01-07;5;0;5;0
46;2021-01-08;13;0;18;0
46;2021-01-09;0;0;18;0
46;2021-01-10;0;0;18;0
46;2021-01-11;2;0;20;0
46;2021-01-12;19;0;39;0
46;2021-01-13;21;0;60;0
46;2021-01-14;23;0;83;0
46;2021-01-15;25;0;108;0
46;2021-01-16;0;0;108;0
46;2021-01-17;0;0;108;0
46;2021-01-18;8;0;116;0
46;2021-01-19;12;0;128;0
46;2021-01-20;28;0;156;0
46;2021-01-21;26;0;182;0
46;2021-01-22;29;0;211;0
46;2021-01-23;0;0;211;0
46;2021-01-24;0;0;211;0
46;2021-01-25;9;0;220;0
46;2021-01-26;4;0;224;0
46;2021-01-27;9;0;233;0
46;2021-01-28;8;6;241;6
46;2021-01-29;4;4;245;10
46;2021-01-30;0;0;245;10
46;2021-01-31;0;0;245;10
46;2021-02-01;9;8;254;18
46;2021-02-02;5;25;259;43
46;2021-02-03;4;15;263;58
46;2021-02-04;15;4;278;62
46;2021-02-05;7;18;285;80
46;2021-02-06;0;0;285;80
46;2021-02-07;1;0;286;80
46;2021-02-08;7;10;293;90
46;2021-02-09;6;4;299;94
46;2021-02-10;18;22;317;116
46;2021-02-11;33;32;350;148
46;2021-02-12;11;27;361;175
46;2021-02-13;0;0;361;175
46;2021-02-14;0;0;361;175
46;2021-02-15;16;4;377;179
46;2021-02-16;16;4;393;183
46;2021-02-17;13;17;406;200
46;2021-02-18;18;11;424;211
46;2021-02-19;20;15;444;226
46;2021-02-20;0;0;444;226
46;2021-02-21;0;0;444;226
46;2021-02-22;5;5;449;231
46;2021-02-23;18;6;467;237
46;2021-02-24;7;7;474;244
46;2021-02-25;21;8;495;252
46;2021-02-26;77;5;572;257
46;2021-02-27;49;0;621;257
46;2021-02-28;0;0;621;257
46;2021-03-01;11;11;632;268
46;2021-03-02;28;8;660;276
46;2021-03-03;47;23;707;299
46;2021-03-04;75;19;782;318
46;2021-03-05;74;12;856;330
46;2021-03-06;49;1;905;331
46;2021-03-07;12;0;917;331
46;2021-03-08;31;5;948;336
46;2021-03-09;70;11;1018;347
46;2021-03-10;51;9;1069;356
46;2021-03-11;67;13;1136;369
46;2021-03-12;94;14;1230;383
46;2021-03-13;59;0;1289;383
46;2021-03-14;0;0;1289;383
46;2021-03-15;41;7;1330;390
46;2021-03-16;36;14;1366;404
46;2021-03-17;29;12;1395;416
46;2021-03-18;45;11;1440;427
46;2021-03-19;69;8;1509;435
46;2021-03-20;30;0;1539;435
46;2021-03-21;0;0;1539;435
46;2021-03-22;62;6;1601;441
46;2021-03-23;51;11;1652;452
46;2021-03-24;66;6;1718;458
46;2021-03-25;93;8;1811;466
46;2021-03-26;80;6;1891;472
46;2021-03-27;40;0;1931;472
46;2021-03-28;1;0;1932;472
46;2021-03-29;58;12;1990;484
46;2021-03-30;82;13;2072;497
46;2021-03-31;106;20;2178;517
46;2021-04-01;90;14;2268;531
47;2020-12-28;0;0;0;0
47;2020-12-29;0;0;0;0
47;2020-12-30;0;0;0;0
47;2020-12-31;0;0;0;0
47;2021-01-01;0;0;0;0
47;2021-01-02;0;0;0;0
47;2021-01-03;0;0;0;0
47;2021-01-04;0;0;0;0
47;2021-01-05;0;0;0;0
47;2021-01-06;0;0;0;0
47;2021-01-07;5;0;5;0
47;2021-01-08;26;0;31;0
47;2021-01-09;7;0;38;0
47;2021-01-10;0;0;38;0
47;2021-01-11;25;0;63;0
47;2021-01-12;22;0;85;0
47;2021-01-13;36;0;121;0
47;2021-01-14;29;0;150;0
47;2021-01-15;38;0;188;0
47;2021-01-16;16;0;204;0
47;2021-01-17;0;0;204;0
47;2021-01-18;24;0;228;0
47;2021-01-19;16;0;244;0
47;2021-01-20;19;0;263;0
47;2021-01-21;16;0;279;0
47;2021-01-22;17;0;296;0
47;2021-01-23;15;1;311;1
47;2021-01-24;0;0;311;1
47;2021-01-25;13;0;324;1
47;2021-01-26;26;1;350;2
47;2021-01-27;26;0;376;2
47;2021-01-28;23;7;399;9
47;2021-01-29;20;16;419;25
47;2021-01-30;19;7;438;32
47;2021-01-31;0;0;438;32
47;2021-02-01;15;32;453;64
47;2021-02-02;44;16;497;80
47;2021-02-03;21;17;518;97
47;2021-02-04;13;28;531;125
47;2021-02-05;13;32;544;157
47;2021-02-06;7;11;551;168
47;2021-02-07;0;0;551;168
47;2021-02-08;6;20;557;188
47;2021-02-09;9;10;566;198
47;2021-02-10;10;11;576;209
47;2021-02-11;16;11;592;220
47;2021-02-12;8;19;600;239
47;2021-02-13;17;9;617;248
47;2021-02-14;0;0;617;248
47;2021-02-15;9;14;626;262
47;2021-02-16;13;19;639;281
47;2021-02-17;14;27;653;308
47;2021-02-18;10;17;663;325
47;2021-02-19;9;19;672;344
47;2021-02-20;3;8;675;352
47;2021-02-21;0;0;675;352
47;2021-02-22;2;16;677;368
47;2021-02-23;10;28;687;396
47;2021-02-24;16;31;703;427
47;2021-02-25;77;20;780;447
47;2021-02-26;133;10;913;457
47;2021-02-27;61;8;974;465
47;2021-02-28;0;0;974;465
47;2021-03-01;15;7;989;472
47;2021-03-02;34;21;1023;493
47;2021-03-03;58;11;1081;504
47;2021-03-04;133;10;1214;514
47;2021-03-05;144;8;1358;522
47;2021-03-06;88;5;1446;527
47;2021-03-07;33;0;1479;527
47;2021-03-08;34;12;1513;539
47;2021-03-09;52;25;1565;564
47;2021-03-10;73;9;1638;573
47;2021-03-11;154;17;1792;590
47;2021-03-12;198;11;1990;601
47;2021-03-13;142;9;2132;610
47;2021-03-14;2;0;2134;610
47;2021-03-15;49;9;2183;619
47;2021-03-16;40;9;2223;628
47;2021-03-17;51;8;2274;636
47;2021-03-18;41;6;2315;642
47;2021-03-19;99;5;2414;647
47;2021-03-20;115;0;2529;647
47;2021-03-21;30;0;2559;647
47;2021-03-22;60;1;2619;648
47;2021-03-23;96;7;2715;655
47;2021-03-24;133;11;2848;666
47;2021-03-25;140;5;2988;671
47;2021-03-26;196;4;3184;675
47;2021-03-27;109;1;3293;676
47;2021-03-28;53;1;3346;677
47;2021-03-29;134;5;3480;682
47;2021-03-30;154;3;3634;685
47;2021-03-31;148;7;3782;692
47;2021-04-01;150;8;3932;700
48;2020-12-28;0;0;0;0
48;2020-12-29;0;0;0;0
48;2020-12-30;0;0;0;0
48;2020-12-31;0;0;0;0
48;2021-01-01;0;0;0;0
48;2021-01-02;0;0;0;0
48;2021-01-03;0;0;0;0
48;2021-01-04;0;0;0;0
48;2021-01-05;0;0;0;0
48;2021-01-06;0;0;0;0
48;2021-01-07;4;0;4;0
48;2021-01-08;2;0;6;0
48;2021-01-09;0;0;6;0
48;2021-01-10;0;0;6;0
48;2021-01-11;2;0;8;0
48;2021-01-12;1;0;9;0
48;2021-01-13;9;0;18;0
48;2021-01-14;8;0;26;0
48;2021-01-15;1;0;27;0
48;2021-01-16;0;0;27;0
48;2021-01-17;0;0;27;0
48;2021-01-18;10;0;37;0
48;2021-01-19;18;0;55;0
48;2021-01-20;12;0;67;0
48;2021-01-21;29;0;96;0
48;2021-01-22;13;0;109;0
48;2021-01-23;2;0;111;0
48;2021-01-24;0;0;111;0
48;2021-01-25;7;0;118;0
48;2021-01-26;22;0;140;0
48;2021-01-27;19;0;159;0
48;2021-01-28;22;4;181;4
48;2021-01-29;10;1;191;5
48;2021-01-30;0;0;191;5
48;2021-01-31;0;0;191;5
48;2021-02-01;7;3;198;8
48;2021-02-02;11;1;209;9
48;2021-02-03;16;8;225;17
48;2021-02-04;18;1;243;18
48;2021-02-05;8;1;251;19
48;2021-02-06;0;0;251;19
48;2021-02-07;0;0;251;19
48;2021-02-08;5;9;256;28
48;2021-02-09;6;16;262;44
48;2021-02-10;2;9;264;53
48;2021-02-11;11;18;275;71
48;2021-02-12;7;8;282;79
48;2021-02-13;0;4;282;83
48;2021-02-14;0;0;282;83
48;2021-02-15;4;4;286;87
48;2021-02-16;0;6;286;93
48;2021-02-17;1;15;287;108
48;2021-02-18;40;14;327;122
48;2021-02-19;3;10;330;132
48;2021-02-20;0;0;330;132
48;2021-02-21;0;0;330;132
48;2021-02-22;2;6;332;138
48;2021-02-23;1;32;333;170
48;2021-02-24;5;18;338;188
48;2021-02-25;28;23;366;211
48;2021-02-26;13;6;379;217
48;2021-02-27;10;0;389;217
48;2021-02-28;1;0;390;217
48;2021-03-01;14;5;404;222
48;2021-03-02;44;6;448;228
48;2021-03-03;19;7;467;235
48;2021-03-04;28;8;495;243
48;2021-03-05;22;12;517;255
48;2021-03-06;22;2;539;257
48;2021-03-07;12;0;551;257
48;2021-03-08;57;5;608;262
48;2021-03-09;46;1;654;263
48;2021-03-10;34;3;688;266
48;2021-03-11;42;4;730;270
48;2021-03-12;44;7;774;277
48;2021-03-13;61;0;835;277
48;2021-03-14;3;0;838;277
48;2021-03-15;17;6;855;283
48;2021-03-16;14;1;869;284
48;2021-03-17;17;8;886;292
48;2021-03-18;13;3;899;295
48;2021-03-19;14;13;913;308
48;2021-03-20;9;0;922;308
48;2021-03-21;0;0;922;308
48;2021-03-22;7;1;929;309
48;2021-03-23;38;1;967;310
48;2021-03-24;16;1;983;311
48;2021-03-25;70;4;1053;315
48;2021-03-26;25;2;1078;317
48;2021-03-27;8;0;1086;317
48;2021-03-28;6;0;1092;317
48;2021-03-29;29;5;1121;322
48;2021-03-30;27;8;1148;330
48;2021-03-31;41;2;1189;332
48;2021-04-01;84;3;1273;335
49;2020-12-28;0;0;0;0
49;2020-12-29;0;0;0;0
49;2020-12-30;0;0;0;0
49;2020-12-31;0;0;0;0
49;2021-01-01;0;0;0;0
49;2021-01-02;0;0;0;0
49;2021-01-03;0;0;0;0
49;2021-01-04;3;0;3;0
49;2021-01-05;2;0;5;0
49;2021-01-06;23;0;28;0
49;2021-01-07;38;0;66;0
49;2021-01-08;31;0;97;0
49;2021-01-09;13;0;110;0
49;2021-01-10;13;0;123;0
49;2021-01-11;44;0;167;0
49;2021-01-12;55;0;222;0
49;2021-01-13;57;0;279;0
49;2021-01-14;57;0;336;0
49;2021-01-15;66;0;402;0
49;2021-01-16;18;0;420;0
49;2021-01-17;16;0;436;0
49;2021-01-18;51;0;487;0
49;2021-01-19;64;0;551;0
49;2021-01-20;88;0;639;0
49;2021-01-21;83;0;722;0
49;2021-01-22;73;0;795;0
49;2021-01-23;24;0;819;0
49;2021-01-24;0;0;819;0
49;2021-01-25;30;2;849;2
49;2021-01-26;54;2;903;4
49;2021-01-27;80;3;983;7
49;2021-01-28;132;10;1115;17
49;2021-01-29;86;17;1201;34
49;2021-01-30;15;8;1216;42
49;2021-01-31;2;6;1218;48
49;2021-02-01;23;23;1241;71
49;2021-02-02;25;39;1266;110
49;2021-02-03;33;48;1299;158
49;2021-02-04;42;53;1341;211
49;2021-02-05;34;57;1375;268
49;2021-02-06;6;12;1381;280
49;2021-02-07;3;8;1384;288
49;2021-02-08;24;40;1408;328
49;2021-02-09;36;40;1444;368
49;2021-02-10;49;57;1493;425
49;2021-02-11;67;81;1560;506
49;2021-02-12;53;67;1613;573
49;2021-02-13;5;10;1618;583
49;2021-02-14;2;10;1620;593
49;2021-02-15;38;43;1658;636
49;2021-02-16;69;61;1727;697
49;2021-02-17;45;97;1772;794
49;2021-02-18;115;134;1887;928
49;2021-02-19;74;83;1961;1011
49;2021-02-20;22;12;1983;1023
49;2021-02-21;0;0;1983;1023
49;2021-02-22;27;40;2010;1063
49;2021-02-23;36;34;2046;1097
49;2021-02-24;87;40;2133;1137
49;2021-02-25;343;39;2476;1176
49;2021-02-26;506;40;2982;1216
49;2021-02-27;187;8;3169;1224
49;2021-02-28;8;2;3177;1226
49;2021-03-01;98;24;3275;1250
49;2021-03-02;239;34;3514;1284
49;2021-03-03;309;34;3823;1318
49;2021-03-04;352;33;4175;1351
49;2021-03-05;433;46;4608;1397
49;2021-03-06;199;8;4807;1405
49;2021-03-07;16;0;4823;1405
49;2021-03-08;171;28;4994;1433
49;2021-03-09;242;29;5236;1462
49;2021-03-10;372;56;5608;1518
49;2021-03-11;512;92;6120;1610
49;2021-03-12;613;66;6733;1676
49;2021-03-13;291;5;7024;1681
49;2021-03-14;0;0;7024;1681
49;2021-03-15;148;30;7172;1711
49;2021-03-16;99;59;7271;1770
49;2021-03-17;67;18;7338;1788
49;2021-03-18;91;59;7429;1847
49;2021-03-19;326;33;7755;1880
49;2021-03-20;220;15;7975;1895
49;2021-03-21;18;9;7993;1904
49;2021-03-22;151;24;8144;1928
49;2021-03-23;328;31;8472;1959
49;2021-03-24;372;26;8844;1985
49;2021-03-25;507;38;9351;2023
49;2021-03-26;577;21;9928;2044
49;2021-03-27;194;11;10122;2055
49;2021-03-28;31;7;10153;2062
49;2021-03-29;195;28;10348;2090
49;2021-03-30;303;31;10651;2121
49;2021-03-31;257;26;10908;2147
49;2021-04-01;376;27;11284;2174
50;2020-12-28;0;0;0;0
50;2020-12-29;0;0;0;0
50;2020-12-30;0;0;0;0
50;2020-12-31;0;0;0;0
50;2021-01-01;0;0;0;0
50;2021-01-02;0;0;0;0
50;2021-01-03;0;0;0;0
50;2021-01-04;0;0;0;0
50;2021-01-05;0;0;0;0
50;2021-01-06;14;0;14;0
50;2021-01-07;24;0;38;0
50;2021-01-08;54;0;92;0
50;2021-01-09;25;0;117;0
50;2021-01-10;2;0;119;0
50;2021-01-11;43;0;162;0
50;2021-01-12;83;0;245;0
50;2021-01-13;72;0;317;0
50;2021-01-14;86;0;403;0
50;2021-01-15;57;0;460;0
50;2021-01-16;17;1;477;1
50;2021-01-17;0;0;477;1
50;2021-01-18;35;0;512;1
50;2021-01-19;54;0;566;1
50;2021-01-20;39;0;605;1
50;2021-01-21;43;0;648;1
50;2021-01-22;38;0;686;1
50;2021-01-23;21;0;707;1
50;2021-01-24;44;0;751;1
50;2021-01-25;96;3;847;4
50;2021-01-26;56;3;903;7
50;2021-01-27;33;4;936;11
50;2021-01-28;56;22;992;33
50;2021-01-29;34;34;1026;67
50;2021-01-30;16;17;1042;84
50;2021-01-31;0;0;1042;84
50;2021-02-01;22;19;1064;103
50;2021-02-02;15;41;1079;144
50;2021-02-03;18;19;1097;163
50;2021-02-04;26;45;1123;208
50;2021-02-05;11;51;1134;259
50;2021-02-06;4;6;1138;265
50;2021-02-07;0;0;1138;265
50;2021-02-08;11;43;1149;308
50;2021-02-09;13;73;1162;381
50;2021-02-10;60;44;1222;425
50;2021-02-11;23;61;1245;486
50;2021-02-12;22;35;1267;521
50;2021-02-13;15;28;1282;549
50;2021-02-14;19;42;1301;591
50;2021-02-15;29;80;1330;671
50;2021-02-16;54;84;1384;755
50;2021-02-17;35;47;1419;802
50;2021-02-18;35;51;1454;853
50;2021-02-19;36;31;1490;884
50;2021-02-20;11;11;1501;895
50;2021-02-21;1;0;1502;895
50;2021-02-22;9;49;1511;944
50;2021-02-23;25;35;1536;979
50;2021-02-24;60;19;1596;998
50;2021-02-25;198;24;1794;1022
50;2021-02-26;332;16;2126;1038
50;2021-02-27;229;9;2355;1047
50;2021-02-28;12;0;2367;1047
50;2021-03-01;44;20;2411;1067
50;2021-03-02;142;26;2553;1093
50;2021-03-03;185;23;2738;1116
50;2021-03-04;327;16;3065;1132
50;2021-03-05;379;9;3444;1141
50;2021-03-06;250;12;3694;1153
50;2021-03-07;42;9;3736;1162
50;2021-03-08;110;44;3846;1206
50;2021-03-09;234;34;4080;1240
50;2021-03-10;207;22;4287;1262
50;2021-03-11;340;7;4627;1269
50;2021-03-12;438;13;5065;1282
50;2021-03-13;345;6;5410;1288
50;2021-03-14;18;0;5428;1288
50;2021-03-15;123;10;5551;1298
50;2021-03-16;81;11;5632;1309
50;2021-03-17;71;9;5703;1318
50;2021-03-18;100;15;5803;1333
50;2021-03-19;230;22;6033;1355
50;2021-03-20;171;7;6204;1362
50;2021-03-21;35;0;6239;1362
50;2021-03-22;149;12;6388;1374
50;2021-03-23;181;8;6569;1382
50;2021-03-24;240;23;6809;1405
50;2021-03-25;345;17;7154;1422
50;2021-03-26;486;17;7640;1439
50;2021-03-27;238;11;7878;1450
50;2021-03-28;13;1;7891;1451
50;2021-03-29;228;23;8119;1474
50;2021-03-30;288;27;8407;1501
50;2021-03-31;262;39;8669;1540
50;2021-04-01;339;81;9008;1621
51;2020-12-28;0;0;0;0
51;2020-12-29;0;0;0;0
51;2020-12-30;0;0;0;0
51;2020-12-31;0;0;0;0
51;2021-01-01;0;0;0;0
51;2021-01-02;0;0;0;0
51;2021-01-03;0;0;0;0
51;2021-01-04;0;0;0;0
51;2021-01-05;0;0;0;0
51;2021-01-06;1;0;1;0
51;2021-01-07;34;0;35;0
51;2021-01-08;52;0;87;0
51;2021-01-09;11;0;98;0
51;2021-01-10;0;0;98;0
51;2021-01-11;80;0;178;0
51;2021-01-12;116;0;294;0
51;2021-01-13;134;0;428;0
51;2021-01-14;136;0;564;0
51;2021-01-15;89;0;653;0
51;2021-01-16;21;0;674;0
51;2021-01-17;8;0;682;0
51;2021-01-18;31;0;713;0
51;2021-01-19;38;0;751;0
51;2021-01-20;56;0;807;0
51;2021-01-21;53;0;860;0
51;2021-01-22;34;0;894;0
51;2021-01-23;20;0;914;0
51;2021-01-24;17;0;931;0
51;2021-01-25;42;0;973;0
51;2021-01-26;49;0;1022;0
51;2021-01-27;44;0;1066;0
51;2021-01-28;40;5;1106;5
51;2021-01-29;28;3;1134;8
51;2021-01-30;4;0;1138;8
51;2021-01-31;4;0;1142;8
51;2021-02-01;11;5;1153;13
51;2021-02-02;30;56;1183;69
51;2021-02-03;43;58;1226;127
51;2021-02-04;67;80;1293;207
51;2021-02-05;88;55;1381;262
51;2021-02-06;4;15;1385;277
51;2021-02-07;0;0;1385;277
51;2021-02-08;6;60;1391;337
51;2021-02-09;13;67;1404;404
51;2021-02-10;8;102;1412;506
51;2021-02-11;2;73;1414;579
51;2021-02-12;21;76;1435;655
51;2021-02-13;2;13;1437;668
51;2021-02-14;1;6;1438;674
51;2021-02-15;28;28;1466;702
51;2021-02-16;35;36;1501;738
51;2021-02-17;40;58;1541;796
51;2021-02-18;47;44;1588;840
51;2021-02-19;21;27;1609;867
51;2021-02-20;10;17;1619;884
51;2021-02-21;1;19;1620;903
51;2021-02-22;15;37;1635;940
51;2021-02-23;37;64;1672;1004
51;2021-02-24;67;50;1739;1054
51;2021-02-25;283;59;2022;1113
51;2021-02-26;298;52;2320;1165
51;2021-02-27;206;2;2526;1167
51;2021-02-28;1;2;2527;1169
51;2021-03-01;87;11;2614;1180
51;2021-03-02;216;24;2830;1204
51;2021-03-03;248;21;3078;1225
51;2021-03-04;279;40;3357;1265
51;2021-03-05;379;53;3736;1318
51;2021-03-06;338;0;4074;1318
51;2021-03-07;27;0;4101;1318
51;2021-03-08;100;11;4201;1329
51;2021-03-09;197;11;4398;1340
51;2021-03-10;245;5;4643;1345
51;2021-03-11;368;8;5011;1353
51;2021-03-12;492;7;5503;1360
51;2021-03-13;491;0;5994;1360
51;2021-03-14;13;0;6007;1360
51;2021-03-15;146;12;6153;1372
51;2021-03-16;103;30;6256;1402
51;2021-03-17;103;34;6359;1436
51;2021-03-18;123;23;6482;1459
51;2021-03-19;275;10;6757;1469
51;2021-03-20;263;8;7020;1477
51;2021-03-21;3;0;7023;1477
51;2021-03-22;127;12;7150;1489
51;2021-03-23;316;10;7466;1499
51;2021-03-24;416;8;7882;1507
51;2021-03-25;507;19;8389;1526
51;2021-03-26;534;24;8923;1550
51;2021-03-27;321;13;9244;1563
51;2021-03-28;22;7;9266;1570
51;2021-03-29;136;13;9402;1583
51;2021-03-30;268;32;9670;1615
51;2021-03-31;208;30;9878;1645
51;2021-04-01;272;10;10150;1655
52;2020-12-28;0;0;0;0
52;2020-12-29;0;0;0;0
52;2020-12-30;0;0;0;0
52;2020-12-31;0;0;0;0
52;2021-01-01;0;0;0;0
52;2021-01-02;0;0;0;0
52;2021-01-03;0;0;0;0
52;2021-01-04;0;0;0;0
52;2021-01-05;0;0;0;0
52;2021-01-06;0;0;0;0
52;2021-01-07;0;0;0;0
52;2021-01-08;13;0;13;0
52;2021-01-09;7;0;20;0
52;2021-01-10;0;0;20;0
52;2021-01-11;21;0;41;0
52;2021-01-12;21;0;62;0
52;2021-01-13;35;0;97;0
52;2021-01-14;43;0;140;0
52;2021-01-15;54;0;194;0
52;2021-01-16;2;0;196;0
52;2021-01-17;0;0;196;0
52;2021-01-18;13;0;209;0
52;2021-01-19;20;0;229;0
52;2021-01-20;16;0;245;0
52;2021-01-21;20;0;265;0
52;2021-01-22;18;0;283;0
52;2021-01-23;1;0;284;0
52;2021-01-24;0;0;284;0
52;2021-01-25;9;0;293;0
52;2021-01-26;22;0;315;0
52;2021-01-27;10;0;325;0
52;2021-01-28;11;0;336;0
52;2021-01-29;10;12;346;12
52;2021-01-30;9;7;355;19
52;2021-01-31;0;0;355;19
52;2021-02-01;7;17;362;36
52;2021-02-02;3;17;365;53
52;2021-02-03;7;25;372;78
52;2021-02-04;18;46;390;124
52;2021-02-05;6;40;396;164
52;2021-02-06;0;0;396;164
52;2021-02-07;0;0;396;164
52;2021-02-08;2;8;398;172
52;2021-02-09;3;21;401;193
52;2021-02-10;7;3;408;196
52;2021-02-11;6;6;414;202
52;2021-02-12;16;11;430;213
52;2021-02-13;0;1;430;214
52;2021-02-14;0;1;430;215
52;2021-02-15;7;8;437;223
52;2021-02-16;0;19;437;242
52;2021-02-17;3;20;440;262
52;2021-02-18;5;12;445;274
52;2021-02-19;3;6;448;280
52;2021-02-20;2;4;450;284
52;2021-02-21;0;0;450;284
52;2021-02-22;6;28;456;312
52;2021-02-23;4;25;460;337
52;2021-02-24;6;7;466;344
52;2021-02-25;47;17;513;361
52;2021-02-26;90;16;603;377
52;2021-02-27;49;5;652;382
52;2021-02-28;0;0;652;382
52;2021-03-01;27;0;679;382
52;2021-03-02;24;1;703;383
52;2021-03-03;59;2;762;385
52;2021-03-04;87;0;849;385
52;2021-03-05;79;1;928;386
52;2021-03-06;121;0;1049;386
52;2021-03-07;0;0;1049;386
52;2021-03-08;52;7;1101;393
52;2021-03-09;112;5;1213;398
52;2021-03-10;37;9;1250;407
52;2021-03-11;86;3;1336;410
52;2021-03-12;76;0;1412;410
52;2021-03-13;110;0;1522;410
52;2021-03-14;4;0;1526;410
52;2021-03-15;32;4;1558;414
52;2021-03-16;18;0;1576;414
52;2021-03-17;16;0;1592;414
52;2021-03-18;36;1;1628;415
52;2021-03-19;64;4;1692;419
52;2021-03-20;30;0;1722;419
52;2021-03-21;0;0;1722;419
52;2021-03-22;34;3;1756;422
52;2021-03-23;76;4;1832;426
52;2021-03-24;62;3;1894;429
52;2021-03-25;141;3;2035;432
52;2021-03-26;142;4;2177;436
52;2021-03-27;60;0;2237;436
52;2021-03-28;6;0;2243;436
52;2021-03-29;53;7;2296;443
52;2021-03-30;94;35;2390;478
52;2021-03-31;98;12;2488;490
52;2021-04-01;119;5;2607;495
53;2020-12-28;0;0;0;0
53;2020-12-29;0;0;0;0
53;2020-12-30;0;0;0;0
53;2020-12-31;0;0;0;0
53;2021-01-01;0;0;0;0
53;2021-01-02;0;0;0;0
53;2021-01-03;0;0;0;0
53;2021-01-04;0;0;0;0
53;2021-01-05;0;0;0;0
53;2021-01-06;0;0;0;0
53;2021-01-07;10;0;10;0
53;2021-01-08;12;0;22;0
53;2021-01-09;14;0;36;0
53;2021-01-10;1;0;37;0
53;2021-01-11;19;0;56;0
53;2021-01-12;17;0;73;0
53;2021-01-13;25;0;98;0
53;2021-01-14;15;0;113;0
53;2021-01-15;24;0;137;0
53;2021-01-16;9;0;146;0
53;2021-01-17;1;0;147;0
53;2021-01-18;26;0;173;0
53;2021-01-19;31;0;204;0
53;2021-01-20;26;0;230;0
53;2021-01-21;29;0;259;0
53;2021-01-22;33;0;292;0
53;2021-01-23;3;0;295;0
53;2021-01-24;0;0;295;0
53;2021-01-25;16;0;311;0
53;2021-01-26;33;0;344;0
53;2021-01-27;29;0;373;0
53;2021-01-28;24;10;397;10
53;2021-01-29;16;13;413;23
53;2021-01-30;5;11;418;34
53;2021-01-31;0;0;418;34
53;2021-02-01;12;15;430;49
53;2021-02-02;6;16;436;65
53;2021-02-03;9;10;445;75
53;2021-02-04;6;15;451;90
53;2021-02-05;21;10;472;100
53;2021-02-06;12;4;484;104
53;2021-02-07;0;0;484;104
53;2021-02-08;9;5;493;109
53;2021-02-09;12;18;505;127
53;2021-02-10;11;28;516;155
53;2021-02-11;24;22;540;177
53;2021-02-12;25;42;565;219
53;2021-02-13;5;3;570;222
53;2021-02-14;0;0;570;222
53;2021-02-15;5;20;575;242
53;2021-02-16;51;36;626;278
53;2021-02-17;26;33;652;311
53;2021-02-18;39;19;691;330
53;2021-02-19;56;28;747;358
53;2021-02-20;5;5;752;363
53;2021-02-21;0;0;752;363
53;2021-02-22;5;17;757;380
53;2021-02-23;4;17;761;397
53;2021-02-24;12;11;773;408
53;2021-02-25;129;11;902;419
53;2021-02-26;158;9;1060;428
53;2021-02-27;36;5;1096;433
53;2021-02-28;0;0;1096;433
53;2021-03-01;33;7;1129;440
53;2021-03-02;65;5;1194;445
53;2021-03-03;56;13;1250;458
53;2021-03-04;152;22;1402;480
53;2021-03-05;116;18;1518;498
53;2021-03-06;77;3;1595;501
53;2021-03-07;11;0;1606;501
53;2021-03-08;79;7;1685;508
53;2021-03-09;136;8;1821;516
53;2021-03-10;103;3;1924;519
53;2021-03-11;110;15;2034;534
53;2021-03-12;203;8;2237;542
53;2021-03-13;167;0;2404;542
53;2021-03-14;0;0;2404;542
53;2021-03-15;94;8;2498;550
53;2021-03-16;51;41;2549;591
53;2021-03-17;37;15;2586;606
53;2021-03-18;52;21;2638;627
53;2021-03-19;94;38;2732;665
53;2021-03-20;49;0;2781;665
53;2021-03-21;0;0;2781;665
53;2021-03-22;122;3;2903;668
53;2021-03-23;158;5;3061;673
53;2021-03-24;102;2;3163;675
53;2021-03-25;246;5;3409;680
53;2021-03-26;226;2;3635;682
53;2021-03-27;40;0;3675;682
53;2021-03-28;0;0;3675;682
53;2021-03-29;137;13;3812;695
53;2021-03-30;217;4;4029;699
53;2021-03-31;185;8;4214;707
53;2021-04-01;184;22;4398;729
54;2020-12-28;0;0;0;0
54;2020-12-29;0;0;0;0
54;2020-12-30;0;0;0;0
54;2020-12-31;1;0;1;0
54;2021-01-01;0;0;1;0
54;2021-01-02;0;0;1;0
54;2021-01-03;0;0;1;0
54;2021-01-04;7;0;8;0
54;2021-01-05;20;0;28;0
54;2021-01-06;45;0;73;0
54;2021-01-07;44;0;117;0
54;2021-01-08;68;0;185;0
54;2021-01-09;11;0;196;0
54;2021-01-10;6;0;202;0
54;2021-01-11;81;0;283;0
54;2021-01-12;59;0;342;0
54;2021-01-13;82;0;424;0
54;2021-01-14;120;0;544;0
54;2021-01-15;148;0;692;0
54;2021-01-16;41;0;733;0
54;2021-01-17;4;0;737;0
54;2021-01-18;69;0;806;0
54;2021-01-19;90;0;896;0
54;2021-01-20;77;0;973;0
54;2021-01-21;60;0;1033;0
54;2021-01-22;56;0;1089;0
54;2021-01-23;25;0;1114;0
54;2021-01-24;5;0;1119;0
54;2021-01-25;69;3;1188;3
54;2021-01-26;4;0;1192;3
54;2021-01-27;1;30;1193;33
54;2021-01-28;3;41;1196;74
54;2021-01-29;0;46;1196;120
54;2021-01-30;0;7;1196;127
54;2021-01-31;1;6;1197;133
54;2021-02-01;0;61;1197;194
54;2021-02-02;2;62;1199;256
54;2021-02-03;18;69;1217;325
54;2021-02-04;43;112;1260;437
54;2021-02-05;75;112;1335;549
54;2021-02-06;11;8;1346;557
54;2021-02-07;0;2;1346;559
54;2021-02-08;5;30;1351;589
54;2021-02-09;11;71;1362;660
54;2021-02-10;18;45;1380;705
54;2021-02-11;15;43;1395;748
54;2021-02-12;16;46;1411;794
54;2021-02-13;21;20;1432;814
54;2021-02-14;1;3;1433;817
54;2021-02-15;12;31;1445;848
54;2021-02-16;14;71;1459;919
54;2021-02-17;38;49;1497;968
54;2021-02-18;57;35;1554;1003
54;2021-02-19;35;31;1589;1034
54;2021-02-20;3;24;1592;1058
54;2021-02-21;0;3;1592;1061
54;2021-02-22;11;23;1603;1084
54;2021-02-23;28;19;1631;1103
54;2021-02-24;107;23;1738;1126
54;2021-02-25;349;74;2087;1200
54;2021-02-26;560;60;2647;1260
54;2021-02-27;284;5;2931;1265
54;2021-02-28;5;0;2936;1265
54;2021-03-01;124;7;3060;1272
54;2021-03-02;270;7;3330;1279
54;2021-03-03;346;0;3676;1279
54;2021-03-04;396;4;4072;1283
54;2021-03-05;565;3;4637;1286
54;2021-03-06;619;1;5256;1287
54;2021-03-07;254;0;5510;1287
54;2021-03-08;150;0;5660;1287
54;2021-03-09;291;2;5951;1289
54;2021-03-10;357;1;6308;1290
54;2021-03-11;433;2;6741;1292
54;2021-03-12;777;1;7518;1293
54;2021-03-13;666;0;8184;1293
54;2021-03-14;39;0;8223;1293
54;2021-03-15;206;3;8429;1296
54;2021-03-16;117;5;8546;1301
54;2021-03-17;183;3;8729;1304
54;2021-03-18;195;1;8924;1305
54;2021-03-19;365;6;9289;1311
54;2021-03-20;380;3;9669;1314
54;2021-03-21;30;1;9699;1315
54;2021-03-22;152;5;9851;1320
54;2021-03-23;282;22;10133;1342
54;2021-03-24;335;22;10468;1364
54;2021-03-25;547;41;11015;1405
54;2021-03-26;613;62;11628;1467
54;2021-03-27;394;12;12022;1479
54;2021-03-28;21;0;12043;1479
54;2021-03-29;227;7;12270;1486
54;2021-03-30;361;48;12631;1534
54;2021-03-31;355;43;12986;1577
54;2021-04-01;393;53;13379;1630
55;2020-12-28;0;0;0;0
55;2020-12-29;0;0;0;0
55;2020-12-30;0;0;0;0
55;2020-12-31;0;0;0;0
55;2021-01-01;0;0;0;0
55;2021-01-02;0;0;0;0
55;2021-01-03;0;0;0;0
55;2021-01-04;0;0;0;0
55;2021-01-05;0;0;0;0
55;2021-01-06;0;0;0;0
55;2021-01-07;9;0;9;0
55;2021-01-08;7;0;16;0
55;2021-01-09;5;0;21;0
55;2021-01-10;0;0;21;0
55;2021-01-11;14;0;35;0
55;2021-01-12;13;0;48;0
55;2021-01-13;9;0;57;0
55;2021-01-14;38;0;95;0
55;2021-01-15;21;0;116;0
55;2021-01-16;7;1;123;1
55;2021-01-17;0;0;123;1
55;2021-01-18;15;0;138;1
55;2021-01-19;24;0;162;1
55;2021-01-20;32;0;194;1
55;2021-01-21;29;0;223;1
55;2021-01-22;24;0;247;1
55;2021-01-23;9;0;256;1
55;2021-01-24;0;0;256;1
55;2021-01-25;18;0;274;1
55;2021-01-26;17;0;291;1
55;2021-01-27;22;0;313;1
55;2021-01-28;27;10;340;11
55;2021-01-29;4;7;344;18
55;2021-01-30;13;4;357;22
55;2021-01-31;0;0;357;22
55;2021-02-01;5;13;362;35
55;2021-02-02;11;14;373;49
55;2021-02-03;3;16;376;65
55;2021-02-04;13;33;389;98
55;2021-02-05;13;16;402;114
55;2021-02-06;1;3;403;117
55;2021-02-07;0;1;403;118
55;2021-02-08;0;4;403;122
55;2021-02-09;6;1;409;123
55;2021-02-10;2;4;411;127
55;2021-02-11;9;5;420;132
55;2021-02-12;5;3;425;135
55;2021-02-13;0;9;425;144
55;2021-02-14;0;0;425;144
55;2021-02-15;3;21;428;165
55;2021-02-16;14;27;442;192
55;2021-02-17;4;31;446;223
55;2021-02-18;4;25;450;248
55;2021-02-19;9;15;459;263
55;2021-02-20;0;11;459;274
55;2021-02-21;0;0;459;274
55;2021-02-22;5;18;464;292
55;2021-02-23;11;18;475;310
55;2021-02-24;25;14;500;324
55;2021-02-25;86;34;586;358
55;2021-02-26;111;7;697;365
55;2021-02-27;68;2;765;367
55;2021-02-28;0;0;765;367
55;2021-03-01;25;3;790;370
55;2021-03-02;64;12;854;382
55;2021-03-03;74;0;928;382
55;2021-03-04;94;3;1022;385
55;2021-03-05;122;7;1144;392
55;2021-03-06;73;0;1217;392
55;2021-03-07;4;0;1221;392
55;2021-03-08;29;0;1250;392
55;2021-03-09;99;0;1349;392
55;2021-03-10;81;2;1430;394
55;2021-03-11;80;7;1510;401
55;2021-03-12;119;6;1629;407
55;2021-03-13;107;0;1736;407
55;2021-03-14;3;0;1739;407
55;2021-03-15;34;4;1773;411
55;2021-03-16;24;8;1797;419
55;2021-03-17;42;0;1839;419
55;2021-03-18;16;4;1855;423
55;2021-03-19;71;2;1926;425
55;2021-03-20;60;1;1986;426
55;2021-03-21;0;0;1986;426
55;2021-03-22;50;1;2036;427
55;2021-03-23;117;4;2153;431
55;2021-03-24;107;0;2260;431
55;2021-03-25;155;7;2415;438
55;2021-03-26;98;1;2513;439
55;2021-03-27;43;0;2556;439
55;2021-03-28;0;0;2556;439
55;2021-03-29;130;0;2686;439
55;2021-03-30;199;1;2885;440
55;2021-03-31;175;1;3060;441
55;2021-04-01;151;2;3211;443
56;2020-12-28;0;0;0;0
56;2020-12-29;0;0;0;0
56;2020-12-30;0;0;0;0
56;2020-12-31;0;0;0;0
56;2021-01-01;0;0;0;0
56;2021-01-02;1;0;1;0
56;2021-01-03;0;0;1;0
56;2021-01-04;0;0;1;0
56;2021-01-05;1;0;2;0
56;2021-01-06;0;0;2;0
56;2021-01-07;33;0;35;0
56;2021-01-08;24;0;59;0
56;2021-01-09;0;0;59;0
56;2021-01-10;0;0;59;0
56;2021-01-11;21;0;80;0
56;2021-01-12;50;0;130;0
56;2021-01-13;54;0;184;0
56;2021-01-14;90;0;274;0
56;2021-01-15;88;0;362;0
56;2021-01-16;31;2;393;2
56;2021-01-17;1;0;394;2
56;2021-01-18;46;0;440;2
56;2021-01-19;34;0;474;2
56;2021-01-20;42;0;516;2
56;2021-01-21;64;0;580;2
56;2021-01-22;59;0;639;2
56;2021-01-23;13;0;652;2
56;2021-01-24;1;0;653;2
56;2021-01-25;64;0;717;2
56;2021-01-26;50;0;767;2
56;2021-01-27;58;5;825;7
56;2021-01-28;48;24;873;31
56;2021-01-29;38;20;911;51
56;2021-01-30;9;2;920;53
56;2021-01-31;0;0;920;53
56;2021-02-01;23;7;943;60
56;2021-02-02;70;19;1013;79
56;2021-02-03;44;18;1057;97
56;2021-02-04;162;25;1219;122
56;2021-02-05;158;47;1377;169
56;2021-02-06;40;21;1417;190
56;2021-02-07;13;1;1430;191
56;2021-02-08;18;29;1448;220
56;2021-02-09;37;38;1485;258
56;2021-02-10;49;58;1534;316
56;2021-02-11;39;80;1573;396
56;2021-02-12;70;53;1643;449
56;2021-02-13;7;8;1650;457
56;2021-02-14;0;1;1650;458
56;2021-02-15;48;52;1698;510
56;2021-02-16;77;36;1775;546
56;2021-02-17;71;48;1846;594
56;2021-02-18;84;51;1930;645
56;2021-02-19;127;46;2057;691
56;2021-02-20;25;6;2082;697
56;2021-02-21;0;0;2082;697
56;2021-02-22;14;51;2096;748
56;2021-02-23;56;34;2152;782
56;2021-02-24;129;62;2281;844
56;2021-02-25;419;162;2700;1006
56;2021-02-26;462;126;3162;1132
56;2021-02-27;223;25;3385;1157
56;2021-02-28;1;14;3386;1171
56;2021-03-01;112;30;3498;1201
56;2021-03-02;188;52;3686;1253
56;2021-03-03;253;40;3939;1293
56;2021-03-04;478;50;4417;1343
56;2021-03-05;534;75;4951;1418
56;2021-03-06;254;7;5205;1425
56;2021-03-07;24;0;5229;1425
56;2021-03-08;157;18;5386;1443
56;2021-03-09;288;23;5674;1466
56;2021-03-10;302;52;5976;1518
56;2021-03-11;600;37;6576;1555
56;2021-03-12;654;50;7230;1605
56;2021-03-13;366;7;7596;1612
56;2021-03-14;12;0;7608;1612
56;2021-03-15;120;33;7728;1645
56;2021-03-16;97;57;7825;1702
56;2021-03-17;75;44;7900;1746
56;2021-03-18;128;146;8028;1892
56;2021-03-19;309;111;8337;2003
56;2021-03-20;192;12;8529;2015
56;2021-03-21;6;1;8535;2016
56;2021-03-22;145;10;8680;2026
56;2021-03-23;298;45;8978;2071
56;2021-03-24;379;43;9357;2114
56;2021-03-25;500;74;9857;2188
56;2021-03-26;569;48;10426;2236
56;2021-03-27;224;12;10650;2248
56;2021-03-28;8;0;10658;2248
56;2021-03-29;187;19;10845;2267
56;2021-03-30;366;43;11211;2310
56;2021-03-31;302;25;11513;2335
56;2021-04-01;412;38;11925;2373
57;2020-12-28;0;0;0;0
57;2020-12-29;0;0;0;0
57;2020-12-30;0;0;0;0
57;2020-12-31;0;0;0;0
57;2021-01-01;0;0;0;0
57;2021-01-02;0;0;0;0
57;2021-01-03;0;0;0;0
57;2021-01-04;0;0;0;0
57;2021-01-05;32;0;32;0
57;2021-01-06;33;0;65;0
57;2021-01-07;105;0;170;0
57;2021-01-08;94;0;264;0
57;2021-01-09;22;0;286;0
57;2021-01-10;8;0;294;0
57;2021-01-11;90;0;384;0
57;2021-01-12;103;0;487;0
57;2021-01-13;118;0;605;0
57;2021-01-14;105;0;710;0
57;2021-01-15;95;0;805;0
57;2021-01-16;43;0;848;0
57;2021-01-17;16;0;864;0
57;2021-01-18;157;0;1021;0
57;2021-01-19;196;0;1217;0
57;2021-01-20;227;0;1444;0
57;2021-01-21;115;0;1559;0
57;2021-01-22;95;0;1654;0
57;2021-01-23;34;0;1688;0
57;2021-01-24;0;0;1688;0
57;2021-01-25;63;39;1751;39
57;2021-01-26;108;37;1859;76
57;2021-01-27;106;35;1965;111
57;2021-01-28;94;34;2059;145
57;2021-01-29;90;74;2149;219
57;2021-01-30;34;27;2183;246
57;2021-01-31;0;8;2183;254
57;2021-02-01;57;56;2240;310
57;2021-02-02;86;49;2326;359
57;2021-02-03;106;59;2432;418
57;2021-02-04;89;131;2521;549
57;2021-02-05;75;53;2596;602
57;2021-02-06;25;45;2621;647
57;2021-02-07;11;18;2632;665
57;2021-02-08;96;158;2728;823
57;2021-02-09;157;166;2885;989
57;2021-02-10;108;177;2993;1166
57;2021-02-11;101;110;3094;1276
57;2021-02-12;97;78;3191;1354
57;2021-02-13;87;14;3278;1368
57;2021-02-14;75;0;3353;1368
57;2021-02-15;47;31;3400;1399
57;2021-02-16;68;95;3468;1494
57;2021-02-17;90;116;3558;1610
57;2021-02-18;87;91;3645;1701
57;2021-02-19;74;64;3719;1765
57;2021-02-20;91;33;3810;1798
57;2021-02-21;29;0;3839;1798
57;2021-02-22;99;63;3938;1861
57;2021-02-23;227;78;4165;1939
57;2021-02-24;250;87;4415;2026
57;2021-02-25;604;96;5019;2122
57;2021-02-26;867;62;5886;2184
57;2021-02-27;612;37;6498;2221
57;2021-02-28;170;6;6668;2227
57;2021-03-01;272;109;6940;2336
57;2021-03-02;443;133;7383;2469
57;2021-03-03;591;131;7974;2600
57;2021-03-04;717;88;8691;2688
57;2021-03-05;966;73;9657;2761
57;2021-03-06;1429;38;11086;2799
57;2021-03-07;858;3;11944;2802
57;2021-03-08;292;55;12236;2857
57;2021-03-09;552;82;12788;2939
57;2021-03-10;634;48;13422;2987
57;2021-03-11;747;87;14169;3074
57;2021-03-12;1062;92;15231;3166
57;2021-03-13;1248;59;16479;3225
57;2021-03-14;400;18;16879;3243
57;2021-03-15;398;50;17277;3293
57;2021-03-16;427;74;17704;3367
57;2021-03-17;387;106;18091;3473
57;2021-03-18;423;99;18514;3572
57;2021-03-19;732;67;19246;3639
57;2021-03-20;863;71;20109;3710
57;2021-03-21;325;15;20434;3725
57;2021-03-22;402;103;20836;3828
57;2021-03-23;596;203;21432;4031
57;2021-03-24;773;158;22205;4189
57;2021-03-25;953;248;23158;4437
57;2021-03-26;868;185;24026;4622
57;2021-03-27;746;216;24772;4838
57;2021-03-28;232;174;25004;5012
57;2021-03-29;347;150;25351;5162
57;2021-03-30;562;209;25913;5371
57;2021-03-31;520;188;26433;5559
57;2021-04-01;603;313;27036;5872
58;2020-12-28;0;0;0;0
58;2020-12-29;0;0;0;0
58;2020-12-30;0;0;0;0
58;2020-12-31;0;0;0;0
58;2021-01-01;0;0;0;0
58;2021-01-02;0;0;0;0
58;2021-01-03;1;0;1;0
58;2021-01-04;0;0;1;0
58;2021-01-05;0;0;1;0
58;2021-01-06;9;0;10;0
58;2021-01-07;14;0;24;0
58;2021-01-08;13;0;37;0
58;2021-01-09;1;0;38;0
58;2021-01-10;0;0;38;0
58;2021-01-11;6;0;44;0
58;2021-01-12;20;0;64;0
58;2021-01-13;33;0;97;0
58;2021-01-14;30;0;127;0
58;2021-01-15;16;0;143;0
58;2021-01-16;0;0;143;0
58;2021-01-17;0;0;143;0
58;2021-01-18;26;0;169;0
58;2021-01-19;54;0;223;0
58;2021-01-20;40;0;263;0
58;2021-01-21;43;0;306;0
58;2021-01-22;30;0;336;0
58;2021-01-23;4;0;340;0
58;2021-01-24;0;0;340;0
58;2021-01-25;19;0;359;0
58;2021-01-26;25;0;384;0
58;2021-01-27;27;4;411;4
58;2021-01-28;38;9;449;13
58;2021-01-29;41;0;490;13
58;2021-01-30;20;0;510;13
58;2021-01-31;1;0;511;13
58;2021-02-01;10;0;521;13
58;2021-02-02;19;6;540;19
58;2021-02-03;8;15;548;34
58;2021-02-04;8;8;556;42
58;2021-02-05;3;15;559;57
58;2021-02-06;3;0;562;57
58;2021-02-07;0;0;562;57
58;2021-02-08;16;13;578;70
58;2021-02-09;22;26;600;96
58;2021-02-10;13;31;613;127
58;2021-02-11;23;34;636;161
58;2021-02-12;8;21;644;182
58;2021-02-13;5;1;649;183
58;2021-02-14;0;0;649;183
58;2021-02-15;9;21;658;204
58;2021-02-16;10;49;668;253
58;2021-02-17;12;50;680;303
58;2021-02-18;24;28;704;331
58;2021-02-19;19;34;723;365
58;2021-02-20;4;6;727;371
58;2021-02-21;0;0;727;371
58;2021-02-22;3;16;730;387
58;2021-02-23;6;17;736;404
58;2021-02-24;5;35;741;439
58;2021-02-25;96;25;837;464
58;2021-02-26;89;27;926;491
58;2021-02-27;53;12;979;503
58;2021-02-28;8;0;987;503
58;2021-03-01;52;11;1039;514
58;2021-03-02;98;20;1137;534
58;2021-03-03;93;8;1230;542
58;2021-03-04;116;6;1346;548
58;2021-03-05;171;4;1517;552
58;2021-03-06;86;4;1603;556
58;2021-03-07;8;0;1611;556
58;2021-03-08;20;14;1631;570
58;2021-03-09;105;26;1736;596
58;2021-03-10;96;12;1832;608
58;2021-03-11;99;14;1931;622
58;2021-03-12;93;4;2024;626
58;2021-03-13;91;3;2115;629
58;2021-03-14;11;0;2126;629
58;2021-03-15;54;8;2180;637
58;2021-03-16;63;9;2243;646
58;2021-03-17;60;18;2303;664
58;2021-03-18;51;4;2354;668
58;2021-03-19;39;2;2393;670
58;2021-03-20;51;0;2444;670
58;2021-03-21;2;0;2446;670
58;2021-03-22;78;2;2524;672
58;2021-03-23;212;1;2736;673
58;2021-03-24;143;0;2879;673
58;2021-03-25;220;0;3099;673
58;2021-03-26;161;2;3260;675
58;2021-03-27;44;0;3304;675
58;2021-03-28;5;0;3309;675
58;2021-03-29;76;21;3385;696
58;2021-03-30;172;16;3557;712
58;2021-03-31;132;22;3689;734
58;2021-04-01;159;12;3848;746
59;2020-12-28;0;0;0;0
59;2020-12-29;0;0;0;0
59;2020-12-30;0;0;0;0
59;2020-12-31;0;0;0;0
59;2021-01-01;0;0;0;0
59;2021-01-02;0;0;0;0
59;2021-01-03;0;0;0;0
59;2021-01-04;6;0;6;0
59;2021-01-05;21;0;27;0
59;2021-01-06;64;0;91;0
59;2021-01-07;124;0;215;0
59;2021-01-08;139;0;354;0
59;2021-01-09;116;0;470;0
59;2021-01-10;75;0;545;0
59;2021-01-11;281;0;826;0
59;2021-01-12;299;0;1125;0
59;2021-01-13;309;0;1434;0
59;2021-01-14;306;0;1740;0
59;2021-01-15;242;0;1982;0
59;2021-01-16;88;3;2070;3
59;2021-01-17;48;0;2118;3
59;2021-01-18;215;0;2333;3
59;2021-01-19;308;0;2641;3
59;2021-01-20;271;0;2912;3
59;2021-01-21;306;1;3218;4
59;2021-01-22;275;0;3493;4
59;2021-01-23;71;0;3564;4
59;2021-01-24;15;1;3579;5
59;2021-01-25;196;13;3775;18
59;2021-01-26;208;16;3983;34
59;2021-01-27;98;52;4081;86
59;2021-01-28;142;92;4223;178
59;2021-01-29;217;114;4440;292
59;2021-01-30;30;55;4470;347
59;2021-01-31;4;18;4474;365
59;2021-02-01;4;196;4478;561
59;2021-02-02;32;235;4510;796
59;2021-02-03;193;184;4703;980
59;2021-02-04;189;204;4892;1184
59;2021-02-05;77;190;4969;1374
59;2021-02-06;27;90;4996;1464
59;2021-02-07;29;22;5025;1486
59;2021-02-08;50;163;5075;1649
59;2021-02-09;65;169;5140;1818
59;2021-02-10;70;182;5210;2000
59;2021-02-11;92;205;5302;2205
59;2021-02-12;113;155;5415;2360
59;2021-02-13;15;71;5430;2431
59;2021-02-14;2;37;5432;2468
59;2021-02-15;110;209;5542;2677
59;2021-02-16;118;226;5660;2903
59;2021-02-17;135;250;5795;3153
59;2021-02-18;225;332;6020;3485
59;2021-02-19;218;267;6238;3752
59;2021-02-20;110;84;6348;3836
59;2021-02-21;32;11;6380;3847
59;2021-02-22;122;185;6502;4032
59;2021-02-23;207;163;6709;4195
59;2021-02-24;519;269;7228;4464
59;2021-02-25;1753;190;8981;4654
59;2021-02-26;1811;116;10792;4770
59;2021-02-27;1226;28;12018;4798
59;2021-02-28;68;16;12086;4814
59;2021-03-01;477;15;12563;4829
59;2021-03-02;824;21;13387;4850
59;2021-03-03;1179;18;14566;4868
59;2021-03-04;1779;40;16345;4908
59;2021-03-05;1738;28;18083;4936
59;2021-03-06;2179;10;20262;4946
59;2021-03-07;798;1;21060;4947
59;2021-03-08;566;73;21626;5020
59;2021-03-09;981;94;22607;5114
59;2021-03-10;1272;89;23879;5203
59;2021-03-11;1788;106;25667;5309
59;2021-03-12;2458;108;28125;5417
59;2021-03-13;3247;40;31372;5457
59;2021-03-14;852;6;32224;5463
59;2021-03-15;803;89;33027;5552
59;2021-03-16;388;119;33415;5671
59;2021-03-17;419;180;33834;5851
59;2021-03-18;405;195;34239;6046
59;2021-03-19;1351;136;35590;6182
59;2021-03-20;2764;91;38354;6273
59;2021-03-21;881;32;39235;6305
59;2021-03-22;848;153;40083;6458
59;2021-03-23;1381;213;41464;6671
59;2021-03-24;1233;238;42697;6909
59;2021-03-25;1981;166;44678;7075
59;2021-03-26;2144;210;46822;7285
59;2021-03-27;2503;80;49325;7365
59;2021-03-28;1148;25;50473;7390
59;2021-03-29;823;224;51296;7614
59;2021-03-30;1154;238;52450;7852
59;2021-03-31;918;306;53368;8158
59;2021-04-01;1126;315;54494;8473
60;2020-12-28;0;0;0;0
60;2020-12-29;0;0;0;0
60;2020-12-30;0;0;0;0
60;2020-12-31;0;0;0;0
60;2021-01-01;0;0;0;0
60;2021-01-02;0;0;0;0
60;2021-01-03;0;0;0;0
60;2021-01-04;0;0;0;0
60;2021-01-05;1;0;1;0
60;2021-01-06;6;0;7;0
60;2021-01-07;18;0;25;0
60;2021-01-08;23;0;48;0
60;2021-01-09;1;0;49;0
60;2021-01-10;11;0;60;0
60;2021-01-11;37;0;97;0
60;2021-01-12;59;0;156;0
60;2021-01-13;64;0;220;0
60;2021-01-14;51;0;271;0
60;2021-01-15;66;0;337;0
60;2021-01-16;17;0;354;0
60;2021-01-17;9;0;363;0
60;2021-01-18;50;0;413;0
60;2021-01-19;49;0;462;0
60;2021-01-20;92;0;554;0
60;2021-01-21;90;0;644;0
60;2021-01-22;89;0;733;0
60;2021-01-23;36;0;769;0
60;2021-01-24;4;0;773;0
60;2021-01-25;54;0;827;0
60;2021-01-26;51;1;878;1
60;2021-01-27;42;0;920;1
60;2021-01-28;16;10;936;11
60;2021-01-29;3;2;939;13
60;2021-01-30;0;0;939;13
60;2021-01-31;0;1;939;14
60;2021-02-01;5;13;944;27
60;2021-02-02;4;18;948;45
60;2021-02-03;13;20;961;65
60;2021-02-04;12;31;973;96
60;2021-02-05;16;40;989;136
60;2021-02-06;3;1;992;137
60;2021-02-07;0;7;992;144
60;2021-02-08;24;65;1016;209
60;2021-02-09;17;53;1033;262
60;2021-02-10;26;85;1059;347
60;2021-02-11;45;70;1104;417
60;2021-02-12;64;77;1168;494
60;2021-02-13;7;21;1175;515
60;2021-02-14;0;11;1175;526
60;2021-02-15;34;30;1209;556
60;2021-02-16;18;50;1227;606
60;2021-02-17;32;53;1259;659
60;2021-02-18;73;45;1332;704
60;2021-02-19;41;44;1373;748
60;2021-02-20;7;12;1380;760
60;2021-02-21;0;10;1380;770
60;2021-02-22;24;39;1404;809
60;2021-02-23;36;35;1440;844
60;2021-02-24;102;30;1542;874
60;2021-02-25;221;12;1763;886
60;2021-02-26;288;11;2051;897
60;2021-02-27;257;0;2308;897
60;2021-02-28;3;0;2311;897
60;2021-03-01;73;4;2384;901
60;2021-03-02;148;2;2532;903
60;2021-03-03;187;18;2719;921
60;2021-03-04;303;28;3022;949
60;2021-03-05;329;17;3351;966
60;2021-03-06;456;6;3807;972
60;2021-03-07;90;0;3897;972
60;2021-03-08;142;8;4039;980
60;2021-03-09;195;14;4234;994
60;2021-03-10;230;17;4464;1011
60;2021-03-11;314;16;4778;1027
60;2021-03-12;446;17;5224;1044
60;2021-03-13;752;6;5976;1050
60;2021-03-14;229;0;6205;1050
60;2021-03-15;244;22;6449;1072
60;2021-03-16;168;25;6617;1097
60;2021-03-17;173;35;6790;1132
60;2021-03-18;193;34;6983;1166
60;2021-03-19;368;26;7351;1192
60;2021-03-20;576;9;7927;1201
60;2021-03-21;358;0;8285;1201
60;2021-03-22;266;34;8551;1235
60;2021-03-23;477;43;9028;1278
60;2021-03-24;479;57;9507;1335
60;2021-03-25;630;40;10137;1375
60;2021-03-26;686;54;10823;1429
60;2021-03-27;843;16;11666;1445
60;2021-03-28;389;0;12055;1445
60;2021-03-29;391;47;12446;1492
60;2021-03-30;504;48;12950;1540
60;2021-03-31;390;65;13340;1605
60;2021-04-01;406;74;13746;1679
61;2020-12-28;0;0;0;0
61;2020-12-29;0;0;0;0
61;2020-12-30;0;0;0;0
61;2020-12-31;0;0;0;0
61;2021-01-01;0;0;0;0
61;2021-01-02;0;0;0;0
61;2021-01-03;0;0;0;0
61;2021-01-04;0;0;0;0
61;2021-01-05;1;0;1;0
61;2021-01-06;8;0;9;0
61;2021-01-07;22;0;31;0
61;2021-01-08;43;0;74;0
61;2021-01-09;9;0;83;0
61;2021-01-10;8;0;91;0
61;2021-01-11;35;0;126;0
61;2021-01-12;35;0;161;0
61;2021-01-13;50;0;211;0
61;2021-01-14;38;0;249;0
61;2021-01-15;52;0;301;0
61;2021-01-16;11;0;312;0
61;2021-01-17;42;0;354;0
61;2021-01-18;83;0;437;0
61;2021-01-19;47;0;484;0
61;2021-01-20;18;0;502;0
61;2021-01-21;49;0;551;0
61;2021-01-22;41;0;592;0
61;2021-01-23;10;1;602;1
61;2021-01-24;9;0;611;1
61;2021-01-25;25;0;636;1
61;2021-01-26;19;0;655;1
61;2021-01-27;20;1;675;2
61;2021-01-28;18;7;693;9
61;2021-01-29;12;13;705;22
61;2021-01-30;17;0;722;22
61;2021-01-31;6;0;728;22
61;2021-02-01;21;26;749;48
61;2021-02-02;17;27;766;75
61;2021-02-03;28;39;794;114
61;2021-02-04;18;22;812;136
61;2021-02-05;24;19;836;155
61;2021-02-06;10;7;846;162
61;2021-02-07;1;19;847;181
61;2021-02-08;33;73;880;254
61;2021-02-09;35;51;915;305
61;2021-02-10;11;42;926;347
61;2021-02-11;19;26;945;373
61;2021-02-12;24;46;969;419
61;2021-02-13;9;31;978;450
61;2021-02-14;0;8;978;458
61;2021-02-15;11;39;989;497
61;2021-02-16;12;37;1001;534
61;2021-02-17;1;35;1002;569
61;2021-02-18;11;26;1013;595
61;2021-02-19;7;8;1020;603
61;2021-02-20;2;14;1022;617
61;2021-02-21;0;5;1022;622
61;2021-02-22;9;22;1031;644
61;2021-02-23;13;20;1044;664
61;2021-02-24;22;18;1066;682
61;2021-02-25;121;16;1187;698
61;2021-02-26;91;14;1278;712
61;2021-02-27;50;16;1328;728
61;2021-02-28;1;2;1329;730
61;2021-03-01;33;46;1362;776
61;2021-03-02;43;35;1405;811
61;2021-03-03;46;27;1451;838
61;2021-03-04;115;16;1566;854
61;2021-03-05;107;17;1673;871
61;2021-03-06;72;11;1745;882
61;2021-03-07;5;0;1750;882
61;2021-03-08;19;15;1769;897
61;2021-03-09;63;7;1832;904
61;2021-03-10;84;10;1916;914
61;2021-03-11;163;7;2079;921
61;2021-03-12;201;5;2280;926
61;2021-03-13;141;4;2421;930
61;2021-03-14;16;0;2437;930
61;2021-03-15;68;0;2505;930
61;2021-03-16;58;0;2563;930
61;2021-03-17;34;0;2597;930
61;2021-03-18;46;2;2643;932
61;2021-03-19;112;2;2755;934
61;2021-03-20;41;0;2796;934
61;2021-03-21;5;0;2801;934
61;2021-03-22;41;2;2842;936
61;2021-03-23;65;0;2907;936
61;2021-03-24;146;2;3053;938
61;2021-03-25;202;0;3255;938
61;2021-03-26;218;2;3473;940
61;2021-03-27;154;0;3627;940
61;2021-03-28;27;0;3654;940
61;2021-03-29;136;9;3790;949
61;2021-03-30;142;2;3932;951
61;2021-03-31;167;0;4099;951
61;2021-04-01;210;5;4309;956
62;2020-12-28;0;0;0;0
62;2020-12-29;0;0;0;0
62;2020-12-30;0;0;0;0
62;2020-12-31;0;0;0;0
62;2021-01-01;0;0;0;0
62;2021-01-02;0;0;0;0
62;2021-01-03;0;0;0;0
62;2021-01-04;0;0;0;0
62;2021-01-05;4;0;4;0
62;2021-01-06;13;0;17;0
62;2021-01-07;60;0;77;0
62;2021-01-08;85;0;162;0
62;2021-01-09;28;0;190;0
62;2021-01-10;13;0;203;0
62;2021-01-11;84;0;287;0
62;2021-01-12;167;0;454;0
62;2021-01-13;161;0;615;0
62;2021-01-14;165;0;780;0
62;2021-01-15;153;0;933;0
62;2021-01-16;38;5;971;5
62;2021-01-17;5;0;976;5
62;2021-01-18;100;0;1076;5
62;2021-01-19;147;0;1223;5
62;2021-01-20;159;0;1382;5
62;2021-01-21;188;0;1570;5
62;2021-01-22;104;0;1674;5
62;2021-01-23;33;0;1707;5
62;2021-01-24;0;0;1707;5
62;2021-01-25;69;1;1776;6
62;2021-01-26;111;2;1887;8
62;2021-01-27;103;26;1990;34
62;2021-01-28;236;42;2226;76
62;2021-01-29;189;41;2415;117
62;2021-01-30;7;27;2422;144
62;2021-01-31;3;0;2425;144
62;2021-02-01;4;60;2429;204
62;2021-02-02;9;121;2438;325
62;2021-02-03;6;96;2444;421
62;2021-02-04;11;104;2455;525
62;2021-02-05;11;90;2466;615
62;2021-02-06;2;23;2468;638
62;2021-02-07;6;0;2474;638
62;2021-02-08;8;89;2482;727
62;2021-02-09;25;104;2507;831
62;2021-02-10;23;149;2530;980
62;2021-02-11;57;139;2587;1119
62;2021-02-12;55;70;2642;1189
62;2021-02-13;15;21;2657;1210
62;2021-02-14;0;0;2657;1210
62;2021-02-15;50;97;2707;1307
62;2021-02-16;97;115;2804;1422
62;2021-02-17;142;178;2946;1600
62;2021-02-18;215;280;3161;1880
62;2021-02-19;190;200;3351;2080
62;2021-02-20;56;25;3407;2105
62;2021-02-21;11;7;3418;2112
62;2021-02-22;76;50;3494;2162
62;2021-02-23;171;79;3665;2241
62;2021-02-24;232;39;3897;2280
62;2021-02-25;956;21;4853;2301
62;2021-02-26;915;30;5768;2331
62;2021-02-27;764;2;6532;2333
62;2021-02-28;30;1;6562;2334
62;2021-03-01;220;3;6782;2337
62;2021-03-02;558;8;7340;2345
62;2021-03-03;647;5;7987;2350
62;2021-03-04;1079;7;9066;2357
62;2021-03-05;1105;8;10171;2365
62;2021-03-06;1903;5;12074;2370
62;2021-03-07;1082;0;13156;2370
62;2021-03-08;232;20;13388;2390
62;2021-03-09;650;26;14038;2416
62;2021-03-10;711;40;14749;2456
62;2021-03-11;1104;143;15853;2599
62;2021-03-12;1257;79;17110;2678
62;2021-03-13;2739;28;19849;2706
62;2021-03-14;1345;5;21194;2711
62;2021-03-15;556;63;21750;2774
62;2021-03-16;276;58;22026;2832
62;2021-03-17;321;52;22347;2884
62;2021-03-18;342;77;22689;2961
62;2021-03-19;812;41;23501;3002
62;2021-03-20;1937;16;25438;3018
62;2021-03-21;1517;2;26955;3020
62;2021-03-22;411;74;27366;3094
62;2021-03-23;876;104;28242;3198
62;2021-03-24;822;113;29064;3311
62;2021-03-25;1164;89;30228;3400
62;2021-03-26;1254;92;31482;3492
62;2021-03-27;2102;19;33584;3511
62;2021-03-28;987;5;34571;3516
62;2021-03-29;529;97;35100;3613
62;2021-03-30;712;142;35812;3755
62;2021-03-31;615;167;36427;3922
62;2021-04-01;708;206;37135;4128
63;2020-12-28;0;0;0;0
63;2020-12-29;0;0;0;0
63;2020-12-30;0;0;0;0
63;2020-12-31;0;0;0;0
63;2021-01-01;0;0;0;0
63;2021-01-02;0;0;0;0
63;2021-01-03;0;0;0;0
63;2021-01-04;0;0;0;0
63;2021-01-05;0;0;0;0
63;2021-01-06;0;0;0;0
63;2021-01-07;29;0;29;0
63;2021-01-08;23;0;52;0
63;2021-01-09;8;0;60;0
63;2021-01-10;10;0;70;0
63;2021-01-11;43;0;113;0
63;2021-01-12;50;0;163;0
63;2021-01-13;92;0;255;0
63;2021-01-14;60;0;315;0
63;2021-01-15;52;0;367;0
63;2021-01-16;17;1;384;1
63;2021-01-17;19;0;403;1
63;2021-01-18;54;0;457;1
63;2021-01-19;59;0;516;1
63;2021-01-20;63;0;579;1
63;2021-01-21;45;0;624;1
63;2021-01-22;52;0;676;1
63;2021-01-23;19;0;695;1
63;2021-01-24;22;0;717;1
63;2021-01-25;34;0;751;1
63;2021-01-26;62;0;813;1
63;2021-01-27;59;1;872;2
63;2021-01-28;76;27;948;29
63;2021-01-29;72;23;1020;52
63;2021-01-30;5;4;1025;56
63;2021-01-31;0;0;1025;56
63;2021-02-01;49;27;1074;83
63;2021-02-02;61;19;1135;102
63;2021-02-03;73;72;1208;174
63;2021-02-04;119;55;1327;229
63;2021-02-05;51;46;1378;275
63;2021-02-06;7;14;1385;289
63;2021-02-07;0;0;1385;289
63;2021-02-08;32;29;1417;318
63;2021-02-09;46;33;1463;351
63;2021-02-10;42;52;1505;403
63;2021-02-11;40;40;1545;443
63;2021-02-12;49;74;1594;517
63;2021-02-13;8;8;1602;525
63;2021-02-14;0;0;1602;525
63;2021-02-15;9;49;1611;574
63;2021-02-16;46;37;1657;611
63;2021-02-17;31;43;1688;654
63;2021-02-18;45;70;1733;724
63;2021-02-19;31;54;1764;778
63;2021-02-20;7;9;1771;787
63;2021-02-21;0;0;1771;787
63;2021-02-22;27;51;1798;838
63;2021-02-23;39;59;1837;897
63;2021-02-24;50;85;1887;982
63;2021-02-25;313;112;2200;1094
63;2021-02-26;417;51;2617;1145
63;2021-02-27;269;13;2886;1158
63;2021-02-28;0;0;2886;1158
63;2021-03-01;115;45;3001;1203
63;2021-03-02;237;55;3238;1258
63;2021-03-03;284;46;3522;1304
63;2021-03-04;480;28;4002;1332
63;2021-03-05;558;37;4560;1369
63;2021-03-06;469;12;5029;1381
63;2021-03-07;68;0;5097;1381
63;2021-03-08;114;44;5211;1425
63;2021-03-09;252;47;5463;1472
63;2021-03-10;296;36;5759;1508
63;2021-03-11;593;27;6352;1535
63;2021-03-12;645;20;6997;1555
63;2021-03-13;396;3;7393;1558
63;2021-03-14;22;0;7415;1558
63;2021-03-15;164;15;7579;1573
63;2021-03-16;133;18;7712;1591
63;2021-03-17;154;25;7866;1616
63;2021-03-18;184;63;8050;1679
63;2021-03-19;312;23;8362;1702
63;2021-03-20;166;6;8528;1708
63;2021-03-21;9;0;8537;1708
63;2021-03-22;183;14;8720;1722
63;2021-03-23;325;43;9045;1765
63;2021-03-24;394;34;9439;1799
63;2021-03-25;501;36;9940;1835
63;2021-03-26;495;56;10435;1891
63;2021-03-27;271;12;10706;1903
63;2021-03-28;112;0;10818;1903
63;2021-03-29;260;39;11078;1942
63;2021-03-30;356;24;11434;1966
63;2021-03-31;342;44;11776;2010
63;2021-04-01;397;26;12173;2036
64;2020-12-28;0;0;0;0
64;2020-12-29;0;0;0;0
64;2020-12-30;0;0;0;0
64;2020-12-31;0;0;0;0
64;2021-01-01;0;0;0;0
64;2021-01-02;0;0;0;0
64;2021-01-03;0;0;0;0
64;2021-01-04;2;0;2;0
64;2021-01-05;2;0;4;0
64;2021-01-06;28;0;32;0
64;2021-01-07;79;0;111;0
64;2021-01-08;106;0;217;0
64;2021-01-09;13;0;230;0
64;2021-01-10;0;0;230;0
64;2021-01-11;69;0;299;0
64;2021-01-12;99;0;398;0
64;2021-01-13;110;0;508;0
64;2021-01-14;119;0;627;0
64;2021-01-15;128;0;755;0
64;2021-01-16;12;0;767;0
64;2021-01-17;0;0;767;0
64;2021-01-18;79;0;846;0
64;2021-01-19;73;0;919;0
64;2021-01-20;88;0;1007;0
64;2021-01-21;119;0;1126;0
64;2021-01-22;80;0;1206;0
64;2021-01-23;21;0;1227;0
64;2021-01-24;3;0;1230;0
64;2021-01-25;40;1;1270;1
64;2021-01-26;60;1;1330;2
64;2021-01-27;48;17;1378;19
64;2021-01-28;86;65;1464;84
64;2021-01-29;50;62;1514;146
64;2021-01-30;18;10;1532;156
64;2021-01-31;6;0;1538;156
64;2021-02-01;26;55;1564;211
64;2021-02-02;42;67;1606;278
64;2021-02-03;49;49;1655;327
64;2021-02-04;37;58;1692;385
64;2021-02-05;30;54;1722;439
64;2021-02-06;16;3;1738;442
64;2021-02-07;5;0;1743;442
64;2021-02-08;32;39;1775;481
64;2021-02-09;42;75;1817;556
64;2021-02-10;46;115;1863;671
64;2021-02-11;74;110;1937;781
64;2021-02-12;49;101;1986;882
64;2021-02-13;8;19;1994;901
64;2021-02-14;2;1;1996;902
64;2021-02-15;10;68;2006;970
64;2021-02-16;14;73;2020;1043
64;2021-02-17;25;50;2045;1093
64;2021-02-18;40;99;2085;1192
64;2021-02-19;25;52;2110;1244
64;2021-02-20;9;14;2119;1258
64;2021-02-21;0;4;2119;1262
64;2021-02-22;68;42;2187;1304
64;2021-02-23;77;76;2264;1380
64;2021-02-24;92;54;2356;1434
64;2021-02-25;150;47;2506;1481
64;2021-02-26;294;34;2800;1515
64;2021-02-27;204;19;3004;1534
64;2021-02-28;3;4;3007;1538
64;2021-03-01;132;34;3139;1572
64;2021-03-02;214;35;3353;1607
64;2021-03-03;266;39;3619;1646
64;2021-03-04;392;55;4011;1701
64;2021-03-05;428;43;4439;1744
64;2021-03-06;308;23;4747;1767
64;2021-03-07;70;3;4817;1770
64;2021-03-08;186;38;5003;1808
64;2021-03-09;342;45;5345;1853
64;2021-03-10;297;38;5642;1891
64;2021-03-11;447;43;6089;1934
64;2021-03-12;480;32;6569;1966
64;2021-03-13;345;10;6914;1976
64;2021-03-14;24;1;6938;1977
64;2021-03-15;178;25;7116;2002
64;2021-03-16;121;24;7237;2026
64;2021-03-17;104;23;7341;2049
64;2021-03-18;177;17;7518;2066
64;2021-03-19;273;13;7791;2079
64;2021-03-20;237;8;8028;2087
64;2021-03-21;152;0;8180;2087
64;2021-03-22;232;50;8412;2137
64;2021-03-23;344;68;8756;2205
64;2021-03-24;427;76;9183;2281
64;2021-03-25;469;65;9652;2346
64;2021-03-26;550;70;10202;2416
64;2021-03-27;363;19;10565;2435
64;2021-03-28;51;2;10616;2437
64;2021-03-29;303;80;10919;2517
64;2021-03-30;459;47;11378;2564
64;2021-03-31;396;67;11774;2631
64;2021-04-01;510;50;12284;2681
65;2020-12-28;0;0;0;0
65;2020-12-29;0;0;0;0
65;2020-12-30;0;0;0;0
65;2020-12-31;0;0;0;0
65;2021-01-01;0;0;0;0
65;2021-01-02;0;0;0;0
65;2021-01-03;0;0;0;0
65;2021-01-04;0;0;0;0
65;2021-01-05;0;0;0;0
65;2021-01-06;0;0;0;0
65;2021-01-07;4;0;4;0
65;2021-01-08;19;0;23;0
65;2021-01-09;21;0;44;0
65;2021-01-10;0;0;44;0
65;2021-01-11;23;0;67;0
65;2021-01-12;17;0;84;0
65;2021-01-13;39;0;123;0
65;2021-01-14;35;0;158;0
65;2021-01-15;53;0;211;0
65;2021-01-16;22;0;233;0
65;2021-01-17;0;0;233;0
65;2021-01-18;41;0;274;0
65;2021-01-19;36;0;310;0
65;2021-01-20;34;0;344;0
65;2021-01-21;41;0;385;0
65;2021-01-22;32;0;417;0
65;2021-01-23;18;0;435;0
65;2021-01-24;0;0;435;0
65;2021-01-25;31;0;466;0
65;2021-01-26;48;1;514;1
65;2021-01-27;34;0;548;1
65;2021-01-28;20;2;568;3
65;2021-01-29;18;10;586;13
65;2021-01-30;11;7;597;20
65;2021-01-31;0;0;597;20
65;2021-02-01;13;11;610;31
65;2021-02-02;19;11;629;42
65;2021-02-03;19;19;648;61
65;2021-02-04;22;22;670;83
65;2021-02-05;17;29;687;112
65;2021-02-06;3;10;690;122
65;2021-02-07;0;0;690;122
65;2021-02-08;35;23;725;145
65;2021-02-09;17;27;742;172
65;2021-02-10;15;18;757;190
65;2021-02-11;23;28;780;218
65;2021-02-12;17;21;797;239
65;2021-02-13;14;6;811;245
65;2021-02-14;0;0;811;245
65;2021-02-15;16;33;827;278
65;2021-02-16;32;43;859;321
65;2021-02-17;17;33;876;354
65;2021-02-18;27;31;903;385
65;2021-02-19;11;33;914;418
65;2021-02-20;4;12;918;430
65;2021-02-21;0;0;918;430
65;2021-02-22;14;27;932;457
65;2021-02-23;22;18;954;475
65;2021-02-24;13;27;967;502
65;2021-02-25;33;9;1000;511
65;2021-02-26;64;43;1064;554
65;2021-02-27;36;8;1100;562
65;2021-02-28;0;0;1100;562
65;2021-03-01;53;21;1153;583
65;2021-03-02;55;14;1208;597
65;2021-03-03;44;13;1252;610
65;2021-03-04;103;15;1355;625
65;2021-03-05;99;22;1454;647
65;2021-03-06;205;6;1659;653
65;2021-03-07;37;0;1696;653
65;2021-03-08;50;22;1746;675
65;2021-03-09;58;27;1804;702
65;2021-03-10;56;14;1860;716
65;2021-03-11;106;27;1966;743
65;2021-03-12;170;14;2136;757
65;2021-03-13;68;7;2204;764
65;2021-03-14;0;0;2204;764
65;2021-03-15;72;13;2276;777
65;2021-03-16;57;16;2333;793
65;2021-03-17;41;6;2374;799
65;2021-03-18;20;17;2394;816
65;2021-03-19;70;13;2464;829
65;2021-03-20;33;2;2497;831
65;2021-03-21;0;0;2497;831
65;2021-03-22;59;18;2556;849
65;2021-03-23;73;24;2629;873
65;2021-03-24;78;11;2707;884
65;2021-03-25;148;15;2855;899
65;2021-03-26;97;3;2952;902
65;2021-03-27;145;1;3097;903
65;2021-03-28;0;0;3097;903
65;2021-03-29;141;18;3238;921
65;2021-03-30;118;38;3356;959
65;2021-03-31;114;10;3470;969
65;2021-04-01;148;26;3618;995
66;2020-12-28;0;0;0;0
66;2020-12-29;0;0;0;0
66;2020-12-30;0;0;0;0
66;2020-12-31;0;0;0;0
66;2021-01-01;0;0;0;0
66;2021-01-02;0;0;0;0
66;2021-01-03;0;0;0;0
66;2021-01-04;3;0;3;0
66;2021-01-05;20;0;23;0
66;2021-01-06;35;0;58;0
66;2021-01-07;17;0;75;0
66;2021-01-08;31;0;106;0
66;2021-01-09;31;0;137;0
66;2021-01-10;0;0;137;0
66;2021-01-11;53;0;190;0
66;2021-01-12;61;0;251;0
66;2021-01-13;112;0;363;0
66;2021-01-14;86;0;449;0
66;2021-01-15;45;0;494;0
66;2021-01-16;6;2;500;2
66;2021-01-17;2;0;502;2
66;2021-01-18;25;0;527;2
66;2021-01-19;35;0;562;2
66;2021-01-20;87;0;649;2
66;2021-01-21;110;0;759;2
66;2021-01-22;97;0;856;2
66;2021-01-23;17;1;873;3
66;2021-01-24;8;2;881;5
66;2021-01-25;42;8;923;13
66;2021-01-26;54;9;977;22
66;2021-01-27;49;9;1026;31
66;2021-01-28;66;18;1092;49
66;2021-01-29;54;22;1146;71
66;2021-01-30;18;13;1164;84
66;2021-01-31;14;1;1178;85
66;2021-02-01;26;26;1204;111
66;2021-02-02;40;42;1244;153
66;2021-02-03;26;69;1270;222
66;2021-02-04;36;59;1306;281
66;2021-02-05;51;42;1357;323
66;2021-02-06;19;14;1376;337
66;2021-02-07;4;8;1380;345
66;2021-02-08;21;20;1401;365
66;2021-02-09;44;31;1445;396
66;2021-02-10;42;69;1487;465
66;2021-02-11;59;94;1546;559
66;2021-02-12;70;74;1616;633
66;2021-02-13;27;21;1643;654
66;2021-02-14;11;7;1654;661
66;2021-02-15;17;27;1671;688
66;2021-02-16;19;56;1690;744
66;2021-02-17;29;52;1719;796
66;2021-02-18;17;56;1736;852
66;2021-02-19;11;50;1747;902
66;2021-02-20;15;18;1762;920
66;2021-02-21;1;8;1763;928
66;2021-02-22;20;50;1783;978
66;2021-02-23;26;45;1809;1023
66;2021-02-24;19;44;1828;1067
66;2021-02-25;151;42;1979;1109
66;2021-02-26;265;45;2244;1154
66;2021-02-27;58;16;2302;1170
66;2021-02-28;1;12;2303;1182
66;2021-03-01;85;38;2388;1220
66;2021-03-02;99;40;2487;1260
66;2021-03-03;118;35;2605;1295
66;2021-03-04;299;56;2904;1351
66;2021-03-05;358;42;3262;1393
66;2021-03-06;201;14;3463;1407
66;2021-03-07;106;3;3569;1410
66;2021-03-08;80;24;3649;1434
66;2021-03-09;186;46;3835;1480
66;2021-03-10;161;32;3996;1512
66;2021-03-11;240;32;4236;1544
66;2021-03-12;351;39;4587;1583
66;2021-03-13;143;12;4730;1595
66;2021-03-14;16;5;4746;1600
66;2021-03-15;106;21;4852;1621
66;2021-03-16;56;20;4908;1641
66;2021-03-17;53;27;4961;1668
66;2021-03-18;56;17;5017;1685
66;2021-03-19;148;11;5165;1696
66;2021-03-20;77;6;5242;1702
66;2021-03-21;12;0;5254;1702
66;2021-03-22;89;18;5343;1720
66;2021-03-23;176;13;5519;1733
66;2021-03-24;184;37;5703;1770
66;2021-03-25;281;22;5984;1792
66;2021-03-26;295;11;6279;1803
66;2021-03-27;121;11;6400;1814
66;2021-03-28;22;2;6422;1816
66;2021-03-29;165;18;6587;1834
66;2021-03-30;235;14;6822;1848
66;2021-03-31;189;24;7011;1872
66;2021-04-01;273;39;7284;1911
67;2020-12-28;0;0;0;0
67;2020-12-29;0;0;0;0
67;2020-12-30;0;0;0;0
67;2020-12-31;0;0;0;0
67;2021-01-01;0;0;0;0
67;2021-01-02;0;0;0;0
67;2021-01-03;0;0;0;0
67;2021-01-04;3;0;3;0
67;2021-01-05;23;0;26;0
67;2021-01-06;19;0;45;0
67;2021-01-07;30;0;75;0
67;2021-01-08;42;0;117;0
67;2021-01-09;16;0;133;0
67;2021-01-10;9;0;142;0
67;2021-01-11;35;0;177;0
67;2021-01-12;82;0;259;0
67;2021-01-13;95;0;354;0
67;2021-01-14;132;0;486;0
67;2021-01-15;117;0;603;0
67;2021-01-16;37;1;640;1
67;2021-01-17;9;0;649;1
67;2021-01-18;75;0;724;1
67;2021-01-19;133;0;857;1
67;2021-01-20;189;0;1046;1
67;2021-01-21;202;0;1248;1
67;2021-01-22;188;0;1436;1
67;2021-01-23;148;0;1584;1
67;2021-01-24;21;0;1605;1
67;2021-01-25;70;6;1675;7
67;2021-01-26;42;18;1717;25
67;2021-01-27;132;14;1849;39
67;2021-01-28;201;36;2050;75
67;2021-01-29;147;30;2197;105
67;2021-01-30;51;10;2248;115
67;2021-01-31;47;3;2295;118
67;2021-02-01;215;38;2510;156
67;2021-02-02;200;63;2710;219
67;2021-02-03;139;62;2849;281
67;2021-02-04;89;97;2938;378
67;2021-02-05;70;91;3008;469
67;2021-02-06;41;29;3049;498
67;2021-02-07;17;2;3066;500
67;2021-02-08;57;55;3123;555
67;2021-02-09;89;95;3212;650
67;2021-02-10;79;114;3291;764
67;2021-02-11;76;110;3367;874
67;2021-02-12;115;99;3482;973
67;2021-02-13;49;22;3531;995
67;2021-02-14;8;3;3539;998
67;2021-02-15;59;75;3598;1073
67;2021-02-16;68;81;3666;1154
67;2021-02-17;51;76;3717;1230
67;2021-02-18;122;174;3839;1404
67;2021-02-19;122;218;3961;1622
67;2021-02-20;43;118;4004;1740
67;2021-02-21;27;66;4031;1806
67;2021-02-22;122;178;4153;1984
67;2021-02-23;102;160;4255;2144
67;2021-02-24;168;113;4423;2257
67;2021-02-25;527;105;4950;2362
67;2021-02-26;820;80;5770;2442
67;2021-02-27;545;38;6315;2480
67;2021-02-28;35;15;6350;2495
67;2021-03-01;133;88;6483;2583
67;2021-03-02;233;102;6716;2685
67;2021-03-03;359;97;7075;2782
67;2021-03-04;587;65;7662;2847
67;2021-03-05;942;70;8604;2917
67;2021-03-06;782;30;9386;2947
67;2021-03-07;82;14;9468;2961
67;2021-03-08;171;56;9639;3017
67;2021-03-09;442;69;10081;3086
67;2021-03-10;396;100;10477;3186
67;2021-03-11;654;109;11131;3295
67;2021-03-12;1192;137;12323;3432
67;2021-03-13;946;45;13269;3477
67;2021-03-14;79;31;13348;3508
67;2021-03-15;277;103;13625;3611
67;2021-03-16;136;99;13761;3710
67;2021-03-17;225;71;13986;3781
67;2021-03-18;243;55;14229;3836
67;2021-03-19;642;49;14871;3885
67;2021-03-20;535;24;15406;3909
67;2021-03-21;55;0;15461;3909
67;2021-03-22;337;37;15798;3946
67;2021-03-23;546;29;16344;3975
67;2021-03-24;617;52;16961;4027
67;2021-03-25;862;25;17823;4052
67;2021-03-26;1137;15;18960;4067
67;2021-03-27;652;11;19612;4078
67;2021-03-28;101;6;19713;4084
67;2021-03-29;510;17;20223;4101
67;2021-03-30;695;36;20918;4137
67;2021-03-31;662;57;21580;4194
67;2021-04-01;661;57;22241;4251
68;2020-12-28;0;0;0;0
68;2020-12-29;0;0;0;0
68;2020-12-30;0;0;0;0
68;2020-12-31;0;0;0;0
68;2021-01-01;0;0;0;0
68;2021-01-02;0;0;0;0
68;2021-01-03;0;0;0;0
68;2021-01-04;0;0;0;0
68;2021-01-05;1;0;1;0
68;2021-01-06;43;0;44;0
68;2021-01-07;8;0;52;0
68;2021-01-08;27;0;79;0
68;2021-01-09;4;0;83;0
68;2021-01-10;0;0;83;0
68;2021-01-11;9;0;92;0
68;2021-01-12;58;0;150;0
68;2021-01-13;69;0;219;0
68;2021-01-14;55;0;274;0
68;2021-01-15;18;0;292;0
68;2021-01-16;0;0;292;0
68;2021-01-17;0;0;292;0
68;2021-01-18;25;0;317;0
68;2021-01-19;27;0;344;0
68;2021-01-20;46;0;390;0
68;2021-01-21;128;0;518;0
68;2021-01-22;90;0;608;0
68;2021-01-23;18;0;626;0
68;2021-01-24;29;0;655;0
68;2021-01-25;70;5;725;5
68;2021-01-26;106;16;831;21
68;2021-01-27;119;20;950;41
68;2021-01-28;136;6;1086;47
68;2021-01-29;93;21;1179;68
68;2021-01-30;7;0;1186;68
68;2021-01-31;0;0;1186;68
68;2021-02-01;39;12;1225;80
68;2021-02-02;57;60;1282;140
68;2021-02-03;47;74;1329;214
68;2021-02-04;60;35;1389;249
68;2021-02-05;71;26;1460;275
68;2021-02-06;12;0;1472;275
68;2021-02-07;0;0;1472;275
68;2021-02-08;85;2;1557;277
68;2021-02-09;124;0;1681;277
68;2021-02-10;125;0;1806;277
68;2021-02-11;96;56;1902;333
68;2021-02-12;129;25;2031;358
68;2021-02-13;7;0;2038;358
68;2021-02-14;3;25;2041;383
68;2021-02-15;51;57;2092;440
68;2021-02-16;89;64;2181;504
68;2021-02-17;94;95;2275;599
68;2021-02-18;126;135;2401;734
68;2021-02-19;77;88;2478;822
68;2021-02-20;8;9;2486;831
68;2021-02-21;0;1;2486;832
68;2021-02-22;32;43;2518;875
68;2021-02-23;82;68;2600;943
68;2021-02-24;119;65;2719;1008
68;2021-02-25;264;76;2983;1084
68;2021-02-26;381;60;3364;1144
68;2021-02-27;256;9;3620;1153
68;2021-02-28;3;0;3623;1153
68;2021-03-01;121;45;3744;1198
68;2021-03-02;206;57;3950;1255
68;2021-03-03;339;46;4289;1301
68;2021-03-04;392;72;4681;1373
68;2021-03-05;550;72;5231;1445
68;2021-03-06;446;9;5677;1454
68;2021-03-07;125;11;5802;1465
68;2021-03-08;155;109;5957;1574
68;2021-03-09;252;120;6209;1694
68;2021-03-10;353;104;6562;1798
68;2021-03-11;516;101;7078;1899
68;2021-03-12;512;96;7590;1995
68;2021-03-13;590;5;8180;2000
68;2021-03-14;233;0;8413;2000
68;2021-03-15;206;40;8619;2040
68;2021-03-16;228;40;8847;2080
68;2021-03-17;185;49;9032;2129
68;2021-03-18;230;61;9262;2190
68;2021-03-19;434;56;9696;2246
68;2021-03-20;206;7;9902;2253
68;2021-03-21;12;0;9914;2253
68;2021-03-22;238;31;10152;2284
68;2021-03-23;402;62;10554;2346
68;2021-03-24;458;71;11012;2417
68;2021-03-25;535;61;11547;2478
68;2021-03-26;655;39;12202;2517
68;2021-03-27;169;11;12371;2528
68;2021-03-28;12;0;12383;2528
68;2021-03-29;359;105;12742;2633
68;2021-03-30;469;83;13211;2716
68;2021-03-31;435;95;13646;2811
68;2021-04-01;415;89;14061;2900
69;2020-12-28;0;0;0;0
69;2020-12-29;0;0;0;0
69;2020-12-30;0;0;0;0
69;2020-12-31;0;0;0;0
69;2021-01-01;0;0;0;0
69;2021-01-02;0;0;0;0
69;2021-01-03;0;0;0;0
69;2021-01-04;0;0;0;0
69;2021-01-05;30;0;30;0
69;2021-01-06;75;0;105;0
69;2021-01-07;95;0;200;0
69;2021-01-08;110;0;310;0
69;2021-01-09;4;0;314;0
69;2021-01-10;0;0;314;0
69;2021-01-11;119;0;433;0
69;2021-01-12;149;0;582;0
69;2021-01-13;138;0;720;0
69;2021-01-14;220;0;940;0
69;2021-01-15;138;0;1078;0
69;2021-01-16;56;1;1134;1
69;2021-01-17;24;0;1158;1
69;2021-01-18;94;0;1252;1
69;2021-01-19;141;0;1393;1
69;2021-01-20;227;0;1620;1
69;2021-01-21;213;0;1833;1
69;2021-01-22;204;1;2037;2
69;2021-01-23;57;0;2094;2
69;2021-01-24;6;0;2100;2
69;2021-01-25;133;3;2233;5
69;2021-01-26;137;11;2370;16
69;2021-01-27;109;41;2479;57
69;2021-01-28;108;45;2587;102
69;2021-01-29;90;35;2677;137
69;2021-01-30;27;0;2704;137
69;2021-01-31;6;0;2710;137
69;2021-02-01;50;42;2760;179
69;2021-02-02;60;58;2820;237
69;2021-02-03;66;57;2886;294
69;2021-02-04;85;92;2971;386
69;2021-02-05;51;73;3022;459
69;2021-02-06;14;2;3036;461
69;2021-02-07;0;0;3036;461
69;2021-02-08;41;81;3077;542
69;2021-02-09;95;149;3172;691
69;2021-02-10;91;175;3263;866
69;2021-02-11;96;257;3359;1123
69;2021-02-12;101;153;3460;1276
69;2021-02-13;25;30;3485;1306
69;2021-02-14;7;3;3492;1309
69;2021-02-15;49;120;3541;1429
69;2021-02-16;36;123;3577;1552
69;2021-02-17;37;149;3614;1701
69;2021-02-18;52;144;3666;1845
69;2021-02-19;47;114;3713;1959
69;2021-02-20;22;55;3735;2014
69;2021-02-21;3;8;3738;2022
69;2021-02-22;19;123;3757;2145
69;2021-02-23;35;127;3792;2272
69;2021-02-24;64;141;3856;2413
69;2021-02-25;336;166;4192;2579
69;2021-02-26;700;79;4892;2658
69;2021-02-27;291;15;5183;2673
69;2021-02-28;20;3;5203;2676
69;2021-03-01;266;56;5469;2732
69;2021-03-02;582;60;6051;2792
69;2021-03-03;584;64;6635;2856
69;2021-03-04;1003;58;7638;2914
69;2021-03-05;1201;43;8839;2957
69;2021-03-06;572;11;9411;2968
69;2021-03-07;46;0;9457;2968
69;2021-03-08;336;31;9793;2999
69;2021-03-09;654;34;10447;3033
69;2021-03-10;687;39;11134;3072
69;2021-03-11;1041;21;12175;3093
69;2021-03-12;1517;28;13692;3121
69;2021-03-13;654;4;14346;3125
69;2021-03-14;241;0;14587;3125
69;2021-03-15;500;28;15087;3153
69;2021-03-16;281;26;15368;3179
69;2021-03-17;285;51;15653;3230
69;2021-03-18;437;68;16090;3298
69;2021-03-19;825;21;16915;3319
69;2021-03-20;470;3;17385;3322
69;2021-03-21;224;2;17609;3324
69;2021-03-22;484;10;18093;3334
69;2021-03-23;965;30;19058;3364
69;2021-03-24;817;42;19875;3406
69;2021-03-25;1134;43;21009;3449
69;2021-03-26;1302;38;22311;3487
69;2021-03-27;380;35;22691;3522
69;2021-03-28;257;3;22948;3525
69;2021-03-29;527;102;23475;3627
69;2021-03-30;969;141;24444;3768
69;2021-03-31;698;155;25142;3923
69;2021-04-01;986;122;26128;4045
70;2020-12-28;0;0;0;0
70;2020-12-29;0;0;0;0
70;2020-12-30;0;0;0;0
70;2020-12-31;0;0;0;0
70;2021-01-01;0;0;0;0
70;2021-01-02;0;0;0;0
70;2021-01-03;0;0;0;0
70;2021-01-04;0;0;0;0
70;2021-01-05;0;0;0;0
70;2021-01-06;1;0;1;0
70;2021-01-07;9;0;10;0
70;2021-01-08;2;0;12;0
70;2021-01-09;0;0;12;0
70;2021-01-10;0;0;12;0
70;2021-01-11;4;0;16;0
70;2021-01-12;20;0;36;0
70;2021-01-13;12;0;48;0
70;2021-01-14;25;0;73;0
70;2021-01-15;11;0;84;0
70;2021-01-16;7;0;91;0
70;2021-01-17;0;0;91;0
70;2021-01-18;19;0;110;0
70;2021-01-19;36;0;146;0
70;2021-01-20;23;0;169;0
70;2021-01-21;46;0;215;0
70;2021-01-22;15;0;230;0
70;2021-01-23;6;0;236;0
70;2021-01-24;0;0;236;0
70;2021-01-25;22;0;258;0
70;2021-01-26;25;0;283;0
70;2021-01-27;16;2;299;2
70;2021-01-28;12;4;311;6
70;2021-01-29;20;5;331;11
70;2021-01-30;16;0;347;11
70;2021-01-31;0;0;347;11
70;2021-02-01;17;3;364;14
70;2021-02-02;11;13;375;27
70;2021-02-03;12;12;387;39
70;2021-02-04;15;8;402;47
70;2021-02-05;7;5;409;52
70;2021-02-06;11;2;420;54
70;2021-02-07;0;0;420;54
70;2021-02-08;22;17;442;71
70;2021-02-09;22;11;464;82
70;2021-02-10;15;11;479;93
70;2021-02-11;19;13;498;106
70;2021-02-12;16;11;514;117
70;2021-02-13;5;5;519;122
70;2021-02-14;0;0;519;122
70;2021-02-15;4;22;523;144
70;2021-02-16;5;31;528;175
70;2021-02-17;13;31;541;206
70;2021-02-18;21;17;562;223
70;2021-02-19;18;22;580;245
70;2021-02-20;10;6;590;251
70;2021-02-21;0;0;590;251
70;2021-02-22;6;18;596;269
70;2021-02-23;11;17;607;286
70;2021-02-24;24;17;631;303
70;2021-02-25;92;21;723;324
70;2021-02-26;77;7;800;331
70;2021-02-27;48;14;848;345
70;2021-02-28;0;0;848;345
70;2021-03-01;38;4;886;349
70;2021-03-02;135;15;1021;364
70;2021-03-03;119;11;1140;375
70;2021-03-04;122;15;1262;390
70;2021-03-05;159;9;1421;399
70;2021-03-06;122;4;1543;403
70;2021-03-07;23;0;1566;403
70;2021-03-08;71;18;1637;421
70;2021-03-09;135;14;1772;435
70;2021-03-10;86;13;1858;448
70;2021-03-11;115;11;1973;459
70;2021-03-12;133;12;2106;471
70;2021-03-13;86;5;2192;476
70;2021-03-14;2;0;2194;476
70;2021-03-15;64;4;2258;480
70;2021-03-16;51;6;2309;486
70;2021-03-17;47;8;2356;494
70;2021-03-18;34;14;2390;508
70;2021-03-19;124;13;2514;521
70;2021-03-20;106;9;2620;530
70;2021-03-21;0;0;2620;530
70;2021-03-22;74;8;2694;538
70;2021-03-23;177;7;2871;545
70;2021-03-24;170;6;3041;551
70;2021-03-25;153;4;3194;555
70;2021-03-26;212;9;3406;564
70;2021-03-27;129;5;3535;569
70;2021-03-28;0;0;3535;569
70;2021-03-29;80;21;3615;590
70;2021-03-30;150;25;3765;615
70;2021-03-31;136;19;3901;634
70;2021-04-01;161;20;4062;654
71;2020-12-28;0;0;0;0
71;2020-12-29;0;0;0;0
71;2020-12-30;0;0;0;0
71;2020-12-31;0;0;0;0
71;2021-01-01;0;0;0;0
71;2021-01-02;0;0;0;0
71;2021-01-03;0;0;0;0
71;2021-01-04;0;0;0;0
71;2021-01-05;1;0;1;0
71;2021-01-06;3;0;4;0
71;2021-01-07;5;0;9;0
71;2021-01-08;14;0;23;0
71;2021-01-09;8;0;31;0
71;2021-01-10;0;0;31;0
71;2021-01-11;23;0;54;0
71;2021-01-12;29;0;83;0
71;2021-01-13;31;0;114;0
71;2021-01-14;42;0;156;0
71;2021-01-15;51;0;207;0
71;2021-01-16;0;0;207;0
71;2021-01-17;0;0;207;0
71;2021-01-18;45;0;252;0
71;2021-01-19;70;0;322;0
71;2021-01-20;53;0;375;0
71;2021-01-21;88;0;463;0
71;2021-01-22;72;0;535;0
71;2021-01-23;32;0;567;0
71;2021-01-24;0;0;567;0
71;2021-01-25;57;0;624;0
71;2021-01-26;74;1;698;1
71;2021-01-27;64;4;762;5
71;2021-01-28;59;5;821;10
71;2021-01-29;53;17;874;27
71;2021-01-30;26;0;900;27
71;2021-01-31;0;0;900;27
71;2021-02-01;39;19;939;46
71;2021-02-02;24;23;963;69
71;2021-02-03;48;26;1011;95
71;2021-02-04;26;47;1037;142
71;2021-02-05;43;39;1080;181
71;2021-02-06;21;0;1101;181
71;2021-02-07;0;0;1101;181
71;2021-02-08;29;30;1130;211
71;2021-02-09;23;39;1153;250
71;2021-02-10;32;25;1185;275
71;2021-02-11;25;47;1210;322
71;2021-02-12;45;34;1255;356
71;2021-02-13;3;11;1258;367
71;2021-02-14;0;0;1258;367
71;2021-02-15;13;49;1271;416
71;2021-02-16;21;65;1292;481
71;2021-02-17;29;72;1321;553
71;2021-02-18;25;48;1346;601
71;2021-02-19;32;44;1378;645
71;2021-02-20;12;18;1390;663
71;2021-02-21;0;0;1390;663
71;2021-02-22;15;52;1405;715
71;2021-02-23;51;52;1456;767
71;2021-02-24;57;43;1513;810
71;2021-02-25;119;34;1632;844
71;2021-02-26;199;43;1831;887
71;2021-02-27;166;19;1997;906
71;2021-02-28;19;0;2016;906
71;2021-03-01;137;26;2153;932
71;2021-03-02;169;13;2322;945
71;2021-03-03;197;44;2519;989
71;2021-03-04;264;29;2783;1018
71;2021-03-05;377;26;3160;1044
71;2021-03-06;234;0;3394;1044
71;2021-03-07;15;0;3409;1044
71;2021-03-08;110;36;3519;1080
71;2021-03-09;249;39;3768;1119
71;2021-03-10;254;23;4022;1142
71;2021-03-11;340;23;4362;1165
71;2021-03-12;336;22;4698;1187
71;2021-03-13;277;0;4975;1187
71;2021-03-14;6;0;4981;1187
71;2021-03-15;173;20;5154;1207
71;2021-03-16;118;6;5272;1213
71;2021-03-17;115;10;5387;1223
71;2021-03-18;152;16;5539;1239
71;2021-03-19;214;12;5753;1251
71;2021-03-20;155;0;5908;1251
71;2021-03-21;6;1;5914;1252
71;2021-03-22;286;22;6200;1274
71;2021-03-23;399;23;6599;1297
71;2021-03-24;404;28;7003;1325
71;2021-03-25;542;36;7545;1361
71;2021-03-26;529;11;8074;1372
71;2021-03-27;193;7;8267;1379
71;2021-03-28;8;0;8275;1379
71;2021-03-29;245;62;8520;1441
71;2021-03-30;302;84;8822;1525
71;2021-03-31;249;82;9071;1607
71;2021-04-01;293;80;9364;1687
72;2020-12-28;0;0;0;0
72;2020-12-29;0;0;0;0
72;2020-12-30;0;0;0;0
72;2020-12-31;0;0;0;0
72;2021-01-01;0;0;0;0
72;2021-01-02;0;0;0;0
72;2021-01-03;0;0;0;0
72;2021-01-04;0;0;0;0
72;2021-01-05;1;0;1;0
72;2021-01-06;9;0;10;0
72;2021-01-07;11;0;21;0
72;2021-01-08;20;0;41;0
72;2021-01-09;3;0;44;0
72;2021-01-10;0;0;44;0
72;2021-01-11;52;0;96;0
72;2021-01-12;52;0;148;0
72;2021-01-13;28;0;176;0
72;2021-01-14;57;0;233;0
72;2021-01-15;46;0;279;0
72;2021-01-16;16;0;295;0
72;2021-01-17;0;0;295;0
72;2021-01-18;23;0;318;0
72;2021-01-19;42;0;360;0
72;2021-01-20;51;0;411;0
72;2021-01-21;84;0;495;0
72;2021-01-22;48;0;543;0
72;2021-01-23;0;0;543;0
72;2021-01-24;0;0;543;0
72;2021-01-25;22;0;565;0
72;2021-01-26;43;6;608;6
72;2021-01-27;33;5;641;11
72;2021-01-28;19;12;660;23
72;2021-01-29;31;8;691;31
72;2021-01-30;1;0;692;31
72;2021-01-31;0;0;692;31
72;2021-02-01;20;18;712;49
72;2021-02-02;17;42;729;91
72;2021-02-03;25;15;754;106
72;2021-02-04;28;38;782;144
72;2021-02-05;31;27;813;171
72;2021-02-06;11;1;824;172
72;2021-02-07;0;0;824;172
72;2021-02-08;13;29;837;201
72;2021-02-09;22;29;859;230
72;2021-02-10;29;41;888;271
72;2021-02-11;57;62;945;333
72;2021-02-12;26;34;971;367
72;2021-02-13;7;7;978;374
72;2021-02-14;0;0;978;374
72;2021-02-15;20;26;998;400
72;2021-02-16;38;65;1036;465
72;2021-02-17;33;31;1069;496
72;2021-02-18;31;24;1100;520
72;2021-02-19;14;35;1114;555
72;2021-02-20;1;0;1115;555
72;2021-02-21;0;0;1115;555
72;2021-02-22;18;29;1133;584
72;2021-02-23;42;31;1175;615
72;2021-02-24;69;15;1244;630
72;2021-02-25;246;11;1490;641
72;2021-02-26;140;17;1630;658
72;2021-02-27;147;0;1777;658
72;2021-02-28;8;0;1785;658
72;2021-03-01;47;18;1832;676
72;2021-03-02;66;24;1898;700
72;2021-03-03;171;24;2069;724
72;2021-03-04;154;50;2223;774
72;2021-03-05;197;37;2420;811
72;2021-03-06;164;11;2584;822
72;2021-03-07;36;0;2620;822
72;2021-03-08;67;29;2687;851
72;2021-03-09;144;39;2831;890
72;2021-03-10;179;47;3010;937
72;2021-03-11;241;26;3251;963
72;2021-03-12;218;11;3469;974
72;2021-03-13;264;10;3733;984
72;2021-03-14;2;0;3735;984
72;2021-03-15;88;11;3823;995
72;2021-03-16;41;10;3864;1005
72;2021-03-17;39;15;3903;1020
72;2021-03-18;42;17;3945;1037
72;2021-03-19;116;6;4061;1043
72;2021-03-20;83;0;4144;1043
72;2021-03-21;4;0;4148;1043
72;2021-03-22;79;19;4227;1062
72;2021-03-23;154;30;4381;1092
72;2021-03-24;184;22;4565;1114
72;2021-03-25;253;17;4818;1131
72;2021-03-26;236;32;5054;1163
72;2021-03-27;109;2;5163;1165
72;2021-03-28;5;0;5168;1165
72;2021-03-29;151;20;5319;1185
72;2021-03-30;220;14;5539;1199
72;2021-03-31;195;12;5734;1211
72;2021-04-01;227;20;5961;1231
73;2020-12-28;0;0;0;0
73;2020-12-29;0;0;0;0
73;2020-12-30;0;0;0;0
73;2020-12-31;0;0;0;0
73;2021-01-01;0;0;0;0
73;2021-01-02;0;0;0;0
73;2021-01-03;0;0;0;0
73;2021-01-04;0;0;0;0
73;2021-01-05;0;0;0;0
73;2021-01-06;0;0;0;0
73;2021-01-07;3;0;3;0
73;2021-01-08;5;0;8;0
73;2021-01-09;0;0;8;0
73;2021-01-10;0;0;8;0
73;2021-01-11;7;0;15;0
73;2021-01-12;21;0;36;0
73;2021-01-13;29;0;65;0
73;2021-01-14;33;0;98;0
73;2021-01-15;40;0;138;0
73;2021-01-16;2;0;140;0
73;2021-01-17;0;0;140;0
73;2021-01-18;29;0;169;0
73;2021-01-19;52;0;221;0
73;2021-01-20;29;0;250;0
73;2021-01-21;24;0;274;0
73;2021-01-22;40;0;314;0
73;2021-01-23;5;0;319;0
73;2021-01-24;0;0;319;0
73;2021-01-25;24;0;343;0
73;2021-01-26;39;0;382;0
73;2021-01-27;33;1;415;1
73;2021-01-28;47;2;462;3
73;2021-01-29;26;3;488;6
73;2021-01-30;8;0;496;6
73;2021-01-31;0;0;496;6
73;2021-02-01;21;7;517;13
73;2021-02-02;24;22;541;35
73;2021-02-03;20;25;561;60
73;2021-02-04;18;32;579;92
73;2021-02-05;29;26;608;118
73;2021-02-06;4;0;612;118
73;2021-02-07;0;0;612;118
73;2021-02-08;14;24;626;142
73;2021-02-09;43;38;669;180
73;2021-02-10;43;12;712;192
73;2021-02-11;40;32;752;224
73;2021-02-12;42;26;794;250
73;2021-02-13;10;0;804;250
73;2021-02-14;1;0;805;250
73;2021-02-15;20;18;825;268
73;2021-02-16;35;28;860;296
73;2021-02-17;27;29;887;325
73;2021-02-18;30;22;917;347
73;2021-02-19;20;14;937;361
73;2021-02-20;3;7;940;368
73;2021-02-21;0;0;940;368
73;2021-02-22;10;38;950;406
73;2021-02-23;50;39;1000;445
73;2021-02-24;65;25;1065;470
73;2021-02-25;85;28;1150;498
73;2021-02-26;229;23;1379;521
73;2021-02-27;126;9;1505;530
73;2021-02-28;0;0;1505;530
73;2021-03-01;110;20;1615;550
73;2021-03-02;110;26;1725;576
73;2021-03-03;141;27;1866;603
73;2021-03-04;222;28;2088;631
73;2021-03-05;323;24;2411;655
73;2021-03-06;233;6;2644;661
73;2021-03-07;42;0;2686;661
73;2021-03-08;84;22;2770;683
73;2021-03-09;150;21;2920;704
73;2021-03-10;173;31;3093;735
73;2021-03-11;259;29;3352;764
73;2021-03-12;321;42;3673;806
73;2021-03-13;204;7;3877;813
73;2021-03-14;14;0;3891;813
73;2021-03-15;77;5;3968;818
73;2021-03-16;28;14;3996;832
73;2021-03-17;51;5;4047;837
73;2021-03-18;109;15;4156;852
73;2021-03-19;182;32;4338;884
73;2021-03-20;83;2;4421;886
73;2021-03-21;14;0;4435;886
73;2021-03-22;79;17;4514;903
73;2021-03-23;134;31;4648;934
73;2021-03-24;126;42;4774;976
73;2021-03-25;210;21;4984;997
73;2021-03-26;285;20;5269;1017
73;2021-03-27;86;0;5355;1017
73;2021-03-28;56;0;5411;1017
73;2021-03-29;124;13;5535;1030
73;2021-03-30;190;10;5725;1040
73;2021-03-31;161;11;5886;1051
73;2021-04-01;186;4;6072;1055
74;2020-12-28;0;0;0;0
74;2020-12-29;0;0;0;0
74;2020-12-30;0;0;0;0
74;2020-12-31;0;0;0;0
74;2021-01-01;0;0;0;0
74;2021-01-02;0;0;0;0
74;2021-01-03;0;0;0;0
74;2021-01-04;0;0;0;0
74;2021-01-05;0;0;0;0
74;2021-01-06;5;0;5;0
74;2021-01-07;33;0;38;0
74;2021-01-08;57;0;95;0
74;2021-01-09;11;0;106;0
74;2021-01-10;6;0;112;0
74;2021-01-11;57;0;169;0
74;2021-01-12;61;0;230;0
74;2021-01-13;46;0;276;0
74;2021-01-14;58;0;334;0
74;2021-01-15;73;0;407;0
74;2021-01-16;24;0;431;0
74;2021-01-17;12;0;443;0
74;2021-01-18;48;0;491;0
74;2021-01-19;59;0;550;0
74;2021-01-20;47;0;597;0
74;2021-01-21;77;0;674;0
74;2021-01-22;50;0;724;0
74;2021-01-23;20;0;744;0
74;2021-01-24;4;0;748;0
74;2021-01-25;40;0;788;0
74;2021-01-26;42;1;830;1
74;2021-01-27;42;1;872;2
74;2021-01-28;34;4;906;6
74;2021-01-29;37;9;943;15
74;2021-01-30;13;1;956;16
74;2021-01-31;4;0;960;16
74;2021-02-01;19;6;979;22
74;2021-02-02;27;20;1006;42
74;2021-02-03;19;18;1025;60
74;2021-02-04;24;24;1049;84
74;2021-02-05;21;50;1070;134
74;2021-02-06;11;19;1081;153
74;2021-02-07;3;15;1084;168
74;2021-02-08;23;50;1107;218
74;2021-02-09;21;44;1128;262
74;2021-02-10;38;42;1166;304
74;2021-02-11;32;93;1198;397
74;2021-02-12;43;61;1241;458
74;2021-02-13;13;26;1254;484
74;2021-02-14;17;10;1271;494
74;2021-02-15;30;63;1301;557
74;2021-02-16;39;66;1340;623
74;2021-02-17;34;41;1374;664
74;2021-02-18;22;57;1396;721
74;2021-02-19;48;41;1444;762
74;2021-02-20;6;8;1450;770
74;2021-02-21;2;1;1452;771
74;2021-02-22;49;27;1501;798
74;2021-02-23;19;41;1520;839
74;2021-02-24;19;30;1539;869
74;2021-02-25;157;34;1696;903
74;2021-02-26;333;32;2029;935
74;2021-02-27;109;5;2138;940
74;2021-02-28;42;2;2180;942
74;2021-03-01;94;32;2274;974
74;2021-03-02;167;21;2441;995
74;2021-03-03;185;21;2626;1016
74;2021-03-04;417;34;3043;1050
74;2021-03-05;477;25;3520;1075
74;2021-03-06;338;8;3858;1083
74;2021-03-07;185;4;4043;1087
74;2021-03-08;154;27;4197;1114
74;2021-03-09;264;24;4461;1138
74;2021-03-10;269;41;4730;1179
74;2021-03-11;426;26;5156;1205
74;2021-03-12;536;43;5692;1248
74;2021-03-13;308;6;6000;1254
74;2021-03-14;57;3;6057;1257
74;2021-03-15;207;30;6264;1287
74;2021-03-16;126;18;6390;1305
74;2021-03-17;125;18;6515;1323
74;2021-03-18;156;6;6671;1329
74;2021-03-19;268;8;6939;1337
74;2021-03-20;131;6;7070;1343
74;2021-03-21;25;0;7095;1343
74;2021-03-22;167;27;7262;1370
74;2021-03-23;301;19;7563;1389
74;2021-03-24;294;11;7857;1400
74;2021-03-25;435;20;8292;1420
74;2021-03-26;486;15;8778;1435
74;2021-03-27;219;8;8997;1443
74;2021-03-28;39;3;9036;1446
74;2021-03-29;328;40;9364;1486
74;2021-03-30;375;45;9739;1531
74;2021-03-31;337;35;10076;1566
74;2021-04-01;395;30;10471;1596
75;2020-12-28;0;0;0;0
75;2020-12-29;0;0;0;0
75;2020-12-30;0;0;0;0
75;2020-12-31;0;0;0;0
75;2021-01-01;1;0;1;0
75;2021-01-02;8;0;9;0
75;2021-01-03;10;0;19;0
75;2021-01-04;28;0;47;0
75;2021-01-05;88;0;135;0
75;2021-01-06;132;0;267;0
75;2021-01-07;151;0;418;0
75;2021-01-08;213;0;631;0
75;2021-01-09;117;0;748;0
75;2021-01-10;101;0;849;0
75;2021-01-11;252;0;1101;0
75;2021-01-12;287;0;1388;0
75;2021-01-13;282;0;1670;0
75;2021-01-14;353;0;2023;0
75;2021-01-15;322;0;2345;0
75;2021-01-16;99;2;2444;2
75;2021-01-17;58;0;2502;2
75;2021-01-18;257;0;2759;2
75;2021-01-19;285;0;3044;2
75;2021-01-20;331;0;3375;2
75;2021-01-21;332;0;3707;2
75;2021-01-22;359;6;4066;8
75;2021-01-23;128;2;4194;10
75;2021-01-24;50;8;4244;18
75;2021-01-25;142;7;4386;25
75;2021-01-26;217;4;4603;29
75;2021-01-27;264;7;4867;36
75;2021-01-28;344;29;5211;65
75;2021-01-29;351;32;5562;97
75;2021-01-30;68;10;5630;107
75;2021-01-31;10;13;5640;120
75;2021-02-01;146;84;5786;204
75;2021-02-02;99;104;5885;308
75;2021-02-03;66;121;5951;429
75;2021-02-04;95;193;6046;622
75;2021-02-05;107;169;6153;791
75;2021-02-06;47;78;6200;869
75;2021-02-07;7;75;6207;944
75;2021-02-08;76;208;6283;1152
75;2021-02-09;65;292;6348;1444
75;2021-02-10;94;325;6442;1769
75;2021-02-11;164;328;6606;2097
75;2021-02-12;163;309;6769;2406
75;2021-02-13;54;52;6823;2458
75;2021-02-14;18;16;6841;2474
75;2021-02-15;48;174;6889;2648
75;2021-02-16;92;280;6981;2928
75;2021-02-17;71;299;7052;3227
75;2021-02-18;109;344;7161;3571
75;2021-02-19;160;372;7321;3943
75;2021-02-20;44;90;7365;4033
75;2021-02-21;7;26;7372;4059
75;2021-02-22;84;171;7456;4230
75;2021-02-23;107;209;7563;4439
75;2021-02-24;172;212;7735;4651
75;2021-02-25;461;225;8196;4876
75;2021-02-26;642;246;8838;5122
75;2021-02-27;387;40;9225;5162
75;2021-02-28;53;18;9278;5180
75;2021-03-01;333;116;9611;5296
75;2021-03-02;606;109;10217;5405
75;2021-03-03;839;84;11056;5489
75;2021-03-04;1315;169;12371;5658
75;2021-03-05;1675;114;14046;5772
75;2021-03-06;1220;32;15266;5804
75;2021-03-07;866;9;16132;5813
75;2021-03-08;764;55;16896;5868
75;2021-03-09;1090;64;17986;5932
75;2021-03-10;1079;79;19065;6011
75;2021-03-11;1522;123;20587;6134
75;2021-03-12;1906;125;22493;6259
75;2021-03-13;1203;29;23696;6288
75;2021-03-14;477;6;24173;6294
75;2021-03-15;938;33;25111;6327
75;2021-03-16;455;48;25566;6375
75;2021-03-17;530;37;26096;6412
75;2021-03-18;599;22;26695;6434
75;2021-03-19;1179;46;27874;6480
75;2021-03-20;755;21;28629;6501
75;2021-03-21;163;2;28792;6503
75;2021-03-22;1120;45;29912;6548
75;2021-03-23;1392;63;31304;6611
75;2021-03-24;1603;82;32907;6693
75;2021-03-25;2023;61;34930;6754
75;2021-03-26;1959;99;36889;6853
75;2021-03-27;996;44;37885;6897
75;2021-03-28;196;5;38081;6902
75;2021-03-29;781;75;38862;6977
75;2021-03-30;1170;176;40032;7153
75;2021-03-31;1008;181;41040;7334
75;2021-04-01;1009;293;42049;7627
76;2020-12-28;0;0;0;0
76;2020-12-29;0;0;0;0
76;2020-12-30;0;0;0;0
76;2020-12-31;0;0;0;0
76;2021-01-01;0;0;0;0
76;2021-01-02;0;0;0;0
76;2021-01-03;0;0;0;0
76;2021-01-04;4;0;4;0
76;2021-01-05;16;0;20;0
76;2021-01-06;99;0;119;0
76;2021-01-07;147;0;266;0
76;2021-01-08;169;0;435;0
76;2021-01-09;79;0;514;0
76;2021-01-10;45;0;559;0
76;2021-01-11;143;0;702;0
76;2021-01-12;128;0;830;0
76;2021-01-13;136;0;966;0
76;2021-01-14;198;0;1164;0
76;2021-01-15;190;0;1354;0
76;2021-01-16;85;3;1439;3
76;2021-01-17;91;1;1530;4
76;2021-01-18;207;0;1737;4
76;2021-01-19;163;0;1900;4
76;2021-01-20;134;0;2034;4
76;2021-01-21;73;0;2107;4
76;2021-01-22;86;1;2193;5
76;2021-01-23;25;0;2218;5
76;2021-01-24;7;0;2225;5
76;2021-01-25;69;22;2294;27
76;2021-01-26;56;49;2350;76
76;2021-01-27;55;45;2405;121
76;2021-01-28;72;41;2477;162
76;2021-01-29;37;44;2514;206
76;2021-01-30;16;20;2530;226
76;2021-01-31;1;7;2531;233
76;2021-02-01;30;87;2561;320
76;2021-02-02;51;107;2612;427
76;2021-02-03;38;114;2650;541
76;2021-02-04;42;173;2692;714
76;2021-02-05;48;101;2740;815
76;2021-02-06;18;54;2758;869
76;2021-02-07;32;82;2790;951
76;2021-02-08;109;278;2899;1229
76;2021-02-09;108;182;3007;1411
76;2021-02-10;104;174;3111;1585
76;2021-02-11;124;131;3235;1716
76;2021-02-12;142;124;3377;1840
76;2021-02-13;12;22;3389;1862
76;2021-02-14;1;0;3390;1862
76;2021-02-15;43;98;3433;1960
76;2021-02-16;54;73;3487;2033
76;2021-02-17;78;83;3565;2116
76;2021-02-18;64;68;3629;2184
76;2021-02-19;53;60;3682;2244
76;2021-02-20;18;19;3700;2263
76;2021-02-21;0;0;3700;2263
76;2021-02-22;34;54;3734;2317
76;2021-02-23;52;44;3786;2361
76;2021-02-24;116;51;3902;2412
76;2021-02-25;612;51;4514;2463
76;2021-02-26;856;48;5370;2511
76;2021-02-27;500;14;5870;2525
76;2021-02-28;2;8;5872;2533
76;2021-03-01;187;146;6059;2679
76;2021-03-02;302;126;6361;2805
76;2021-03-03;521;56;6882;2861
76;2021-03-04;653;36;7535;2897
76;2021-03-05;972;33;8507;2930
76;2021-03-06;674;4;9181;2934
76;2021-03-07;110;3;9291;2937
76;2021-03-08;236;42;9527;2979
76;2021-03-09;508;54;10035;3033
76;2021-03-10;579;45;10614;3078
76;2021-03-11;1004;96;11618;3174
76;2021-03-12;1241;28;12859;3202
76;2021-03-13;938;4;13797;3206
76;2021-03-14;135;0;13932;3206
76;2021-03-15;249;11;14181;3217
76;2021-03-16;193;27;14374;3244
76;2021-03-17;214;14;14588;3258
76;2021-03-18;244;35;14832;3293
76;2021-03-19;553;18;15385;3311
76;2021-03-20;711;11;16096;3322
76;2021-03-21;126;0;16222;3322
76;2021-03-22;351;13;16573;3335
76;2021-03-23;682;24;17255;3359
76;2021-03-24;687;28;17942;3387
76;2021-03-25;973;53;18915;3440
76;2021-03-26;1254;31;20169;3471
76;2021-03-27;750;18;20919;3489
76;2021-03-28;117;0;21036;3489
76;2021-03-29;619;80;21655;3569
76;2021-03-30;825;84;22480;3653
76;2021-03-31;795;74;23275;3727
76;2021-04-01;763;162;24038;3889
77;2020-12-28;0;0;0;0
77;2020-12-29;0;0;0;0
77;2020-12-30;0;0;0;0
77;2020-12-31;0;0;0;0
77;2021-01-01;0;0;0;0
77;2021-01-02;0;0;0;0
77;2021-01-03;0;0;0;0
77;2021-01-04;1;0;1;0
77;2021-01-05;13;0;14;0
77;2021-01-06;22;0;36;0
77;2021-01-07;59;0;95;0
77;2021-01-08;77;0;172;0
77;2021-01-09;27;0;199;0
77;2021-01-10;31;0;230;0
77;2021-01-11;80;0;310;0
77;2021-01-12;107;0;417;0
77;2021-01-13;122;0;539;0
77;2021-01-14;116;0;655;0
77;2021-01-15;122;0;777;0
77;2021-01-16;25;0;802;0
77;2021-01-17;14;0;816;0
77;2021-01-18;49;0;865;0
77;2021-01-19;64;0;929;0
77;2021-01-20;119;0;1048;0
77;2021-01-21;65;0;1113;0
77;2021-01-22;44;0;1157;0
77;2021-01-23;9;0;1166;0
77;2021-01-24;1;0;1167;0
77;2021-01-25;31;5;1198;5
77;2021-01-26;39;2;1237;7
77;2021-01-27;36;3;1273;10
77;2021-01-28;59;9;1332;19
77;2021-01-29;39;20;1371;39
77;2021-01-30;1;1;1372;40
77;2021-01-31;0;0;1372;40
77;2021-02-01;23;20;1395;60
77;2021-02-02;23;33;1418;93
77;2021-02-03;34;68;1452;161
77;2021-02-04;30;86;1482;247
77;2021-02-05;39;95;1521;342
77;2021-02-06;6;20;1527;362
77;2021-02-07;2;9;1529;371
77;2021-02-08;31;84;1560;455
77;2021-02-09;27;134;1587;589
77;2021-02-10;70;136;1657;725
77;2021-02-11;72;123;1729;848
77;2021-02-12;49;76;1778;924
77;2021-02-13;11;10;1789;934
77;2021-02-14;1;9;1790;943
77;2021-02-15;40;51;1830;994
77;2021-02-16;39;58;1869;1052
77;2021-02-17;46;49;1915;1101
77;2021-02-18;65;62;1980;1163
77;2021-02-19;53;50;2033;1213
77;2021-02-20;1;1;2034;1214
77;2021-02-21;0;1;2034;1215
77;2021-02-22;17;14;2051;1229
77;2021-02-23;18;19;2069;1248
77;2021-02-24;61;18;2130;1266
77;2021-02-25;235;35;2365;1301
77;2021-02-26;266;38;2631;1339
77;2021-02-27;219;1;2850;1340
77;2021-02-28;8;0;2858;1340
77;2021-03-01;88;20;2946;1360
77;2021-03-02;166;40;3112;1400
77;2021-03-03;361;54;3473;1454
77;2021-03-04;478;44;3951;1498
77;2021-03-05;581;28;4532;1526
77;2021-03-06;674;7;5206;1533
77;2021-03-07;175;1;5381;1534
77;2021-03-08;164;21;5545;1555
77;2021-03-09;362;19;5907;1574
77;2021-03-10;350;24;6257;1598
77;2021-03-11;521;27;6778;1625
77;2021-03-12;603;21;7381;1646
77;2021-03-13;804;4;8185;1650
77;2021-03-14;249;0;8434;1650
77;2021-03-15;328;8;8762;1658
77;2021-03-16;121;11;8883;1669
77;2021-03-17;176;12;9059;1681
77;2021-03-18;246;21;9305;1702
77;2021-03-19;361;13;9666;1715
77;2021-03-20;346;0;10012;1715
77;2021-03-21;66;0;10078;1715
77;2021-03-22;428;12;10506;1727
77;2021-03-23;696;16;11202;1743
77;2021-03-24;594;37;11796;1780
77;2021-03-25;928;19;12724;1799
77;2021-03-26;993;15;13717;1814
77;2021-03-27;554;1;14271;1815
77;2021-03-28;272;1;14543;1816
77;2021-03-29;374;22;14917;1838
77;2021-03-30;574;39;15491;1877
77;2021-03-31;438;42;15929;1919
77;2021-04-01;533;87;16462;2006
78;2020-12-28;0;0;0;0
78;2020-12-29;0;0;0;0
78;2020-12-30;0;0;0;0
78;2020-12-31;0;0;0;0
78;2021-01-01;0;0;0;0
78;2021-01-02;0;0;0;0
78;2021-01-03;0;0;0;0
78;2021-01-04;18;0;18;0
78;2021-01-05;30;0;48;0
78;2021-01-06;35;0;83;0
78;2021-01-07;60;0;143;0
78;2021-01-08;81;0;224;0
78;2021-01-09;4;0;228;0
78;2021-01-10;0;0;228;0
78;2021-01-11;113;0;341;0
78;2021-01-12;124;0;465;0
78;2021-01-13;98;0;563;0
78;2021-01-14;98;0;661;0
78;2021-01-15;100;0;761;0
78;2021-01-16;2;0;763;0
78;2021-01-17;0;0;763;0
78;2021-01-18;74;0;837;0
78;2021-01-19;106;0;943;0
78;2021-01-20;78;0;1021;0
78;2021-01-21;152;1;1173;1
78;2021-01-22;130;1;1303;2
78;2021-01-23;7;0;1310;2
78;2021-01-24;2;0;1312;2
78;2021-01-25;48;1;1360;3
78;2021-01-26;82;2;1442;5
78;2021-01-27;88;3;1530;8
78;2021-01-28;131;5;1661;13
78;2021-01-29;65;5;1726;18
78;2021-01-30;9;0;1735;18
78;2021-01-31;0;0;1735;18
78;2021-02-01;22;26;1757;44
78;2021-02-02;27;39;1784;83
78;2021-02-03;31;28;1815;111
78;2021-02-04;42;74;1857;185
78;2021-02-05;47;73;1904;258
78;2021-02-06;7;9;1911;267
78;2021-02-07;10;0;1921;267
78;2021-02-08;30;81;1951;348
78;2021-02-09;52;127;2003;475
78;2021-02-10;63;95;2066;570
78;2021-02-11;79;147;2145;717
78;2021-02-12;132;124;2277;841
78;2021-02-13;10;7;2287;848
78;2021-02-14;0;0;2287;848
78;2021-02-15;35;67;2322;915
78;2021-02-16;49;96;2371;1011
78;2021-02-17;43;98;2414;1109
78;2021-02-18;76;166;2490;1275
78;2021-02-19;74;92;2564;1367
78;2021-02-20;12;4;2576;1371
78;2021-02-21;0;0;2576;1371
78;2021-02-22;40;50;2616;1421
78;2021-02-23;31;45;2647;1466
78;2021-02-24;99;64;2746;1530
78;2021-02-25;199;62;2945;1592
78;2021-02-26;320;44;3265;1636
78;2021-02-27;311;4;3576;1640
78;2021-02-28;27;0;3603;1640
78;2021-03-01;122;32;3725;1672
78;2021-03-02;358;31;4083;1703
78;2021-03-03;431;47;4514;1750
78;2021-03-04;569;80;5083;1830
78;2021-03-05;714;70;5797;1900
78;2021-03-06;752;6;6549;1906
78;2021-03-07;266;0;6815;1906
78;2021-03-08;195;20;7010;1926
78;2021-03-09;477;34;7487;1960
78;2021-03-10;447;48;7934;2008
78;2021-03-11;643;75;8577;2083
78;2021-03-12;876;56;9453;2139
78;2021-03-13;787;3;10240;2142
78;2021-03-14;136;0;10376;2142
78;2021-03-15;443;11;10819;2153
78;2021-03-16;204;24;11023;2177
78;2021-03-17;231;10;11254;2187
78;2021-03-18;284;26;11538;2213
78;2021-03-19;631;19;12169;2232
78;2021-03-20;387;2;12556;2234
78;2021-03-21;46;0;12602;2234
78;2021-03-22;503;12;13105;2246
78;2021-03-23;884;12;13989;2258
78;2021-03-24;828;31;14817;2289
78;2021-03-25;1180;21;15997;2310
78;2021-03-26;1138;25;17135;2335
78;2021-03-27;608;9;17743;2344
78;2021-03-28;253;2;17996;2346
78;2021-03-29;509;29;18505;2375
78;2021-03-30;718;49;19223;2424
78;2021-03-31;695;73;19918;2497
78;2021-04-01;666;112;20584;2609
79;2020-12-28;0;0;0;0
79;2020-12-29;0;0;0;0
79;2020-12-30;0;0;0;0
79;2020-12-31;0;0;0;0
79;2021-01-01;0;0;0;0
79;2021-01-02;0;0;0;0
79;2021-01-03;0;0;0;0
79;2021-01-04;0;0;0;0
79;2021-01-05;0;0;0;0
79;2021-01-06;0;0;0;0
79;2021-01-07;11;0;11;0
79;2021-01-08;23;0;34;0
79;2021-01-09;12;0;46;0
79;2021-01-10;0;0;46;0
79;2021-01-11;31;0;77;0
79;2021-01-12;34;0;111;0
79;2021-01-13;36;0;147;0
79;2021-01-14;54;0;201;0
79;2021-01-15;54;0;255;0
79;2021-01-16;4;1;259;1
79;2021-01-17;0;0;259;1
79;2021-01-18;25;0;284;1
79;2021-01-19;63;0;347;1
79;2021-01-20;102;0;449;1
79;2021-01-21;120;0;569;1
79;2021-01-22;61;0;630;1
79;2021-01-23;4;0;634;1
79;2021-01-24;0;0;634;1
79;2021-01-25;35;1;669;2
79;2021-01-26;25;2;694;4
79;2021-01-27;37;6;731;10
79;2021-01-28;43;13;774;23
79;2021-01-29;21;13;795;36
79;2021-01-30;0;0;795;36
79;2021-01-31;0;0;795;36
79;2021-02-01;15;16;810;52
79;2021-02-02;13;8;823;60
79;2021-02-03;15;6;838;66
79;2021-02-04;12;16;850;82
79;2021-02-05;25;13;875;95
79;2021-02-06;0;0;875;95
79;2021-02-07;0;0;875;95
79;2021-02-08;13;18;888;113
79;2021-02-09;16;65;904;178
79;2021-02-10;31;66;935;244
79;2021-02-11;36;93;971;337
79;2021-02-12;26;58;997;395
79;2021-02-13;6;7;1003;402
79;2021-02-14;0;0;1003;402
79;2021-02-15;10;24;1013;426
79;2021-02-16;26;36;1039;462
79;2021-02-17;15;53;1054;515
79;2021-02-18;17;67;1071;582
79;2021-02-19;12;39;1083;621
79;2021-02-20;1;1;1084;622
79;2021-02-21;0;0;1084;622
79;2021-02-22;4;44;1088;666
79;2021-02-23;13;29;1101;695
79;2021-02-24;12;22;1113;717
79;2021-02-25;201;34;1314;751
79;2021-02-26;203;23;1517;774
79;2021-02-27;206;0;1723;774
79;2021-02-28;16;0;1739;774
79;2021-03-01;17;18;1756;792
79;2021-03-02;108;18;1864;810
79;2021-03-03;135;25;1999;835
79;2021-03-04;276;26;2275;861
79;2021-03-05;356;29;2631;890
79;2021-03-06;196;0;2827;890
79;2021-03-07;5;0;2832;890
79;2021-03-08;21;20;2853;910
79;2021-03-09;141;14;2994;924
79;2021-03-10;147;21;3141;945
79;2021-03-11;279;14;3420;959
79;2021-03-12;296;5;3716;964
79;2021-03-13;170;0;3886;964
79;2021-03-14;3;0;3889;964
79;2021-03-15;47;10;3936;974
79;2021-03-16;35;6;3971;980
79;2021-03-17;19;5;3990;985
79;2021-03-18;23;10;4013;995
79;2021-03-19;82;9;4095;1004
79;2021-03-20;147;0;4242;1004
79;2021-03-21;0;0;4242;1004
79;2021-03-22;47;6;4289;1010
79;2021-03-23;109;12;4398;1022
79;2021-03-24;180;0;4578;1022
79;2021-03-25;275;5;4853;1027
79;2021-03-26;295;4;5148;1031
79;2021-03-27;99;0;5247;1031
79;2021-03-28;0;0;5247;1031
79;2021-03-29;153;7;5400;1038
79;2021-03-30;232;0;5632;1038
79;2021-03-31;256;17;5888;1055
79;2021-04-01;245;15;6133;1070
80;2020-12-28;0;0;0;0
80;2020-12-29;0;0;0;0
80;2020-12-30;0;0;0;0
80;2020-12-31;0;0;0;0
80;2021-01-01;0;0;0;0
80;2021-01-02;0;0;0;0
80;2021-01-03;1;0;1;0
80;2021-01-04;0;0;1;0
80;2021-01-05;0;0;1;0
80;2021-01-06;1;0;2;0
80;2021-01-07;40;0;42;0
80;2021-01-08;39;0;81;0
80;2021-01-09;20;0;101;0
80;2021-01-10;4;0;105;0
80;2021-01-11;37;0;142;0
80;2021-01-12;49;0;191;0
80;2021-01-13;66;0;257;0
80;2021-01-14;53;0;310;0
80;2021-01-15;37;0;347;0
80;2021-01-16;14;0;361;0
80;2021-01-17;9;0;370;0
80;2021-01-18;37;0;407;0
80;2021-01-19;63;0;470;0
80;2021-01-20;64;0;534;0
80;2021-01-21;63;0;597;0
80;2021-01-22;61;0;658;0
80;2021-01-23;36;0;694;0
80;2021-01-24;44;0;738;0
80;2021-01-25;71;0;809;0
80;2021-01-26;82;2;891;2
80;2021-01-27;63;2;954;4
80;2021-01-28;41;39;995;43
80;2021-01-29;42;35;1037;78
80;2021-01-30;4;14;1041;92
80;2021-01-31;0;0;1041;92
80;2021-02-01;3;40;1044;132
80;2021-02-02;5;50;1049;182
80;2021-02-03;1;50;1050;232
80;2021-02-04;2;36;1052;268
80;2021-02-05;6;22;1058;290
80;2021-02-06;2;6;1060;296
80;2021-02-07;0;0;1060;296
80;2021-02-08;19;24;1079;320
80;2021-02-09;20;31;1099;351
80;2021-02-10;16;28;1115;379
80;2021-02-11;15;27;1130;406
80;2021-02-12;11;33;1141;439
80;2021-02-13;18;18;1159;457
80;2021-02-14;7;40;1166;497
80;2021-02-15;27;59;1193;556
80;2021-02-16;44;90;1237;646
80;2021-02-17;26;52;1263;698
80;2021-02-18;36;53;1299;751
80;2021-02-19;48;41;1347;792
80;2021-02-20;1;23;1348;815
80;2021-02-21;8;4;1356;819
80;2021-02-22;3;32;1359;851
80;2021-02-23;18;28;1377;879
80;2021-02-24;63;71;1440;950
80;2021-02-25;228;34;1668;984
80;2021-02-26;357;23;2025;1007
80;2021-02-27;182;2;2207;1009
80;2021-02-28;9;3;2216;1012
80;2021-03-01;106;4;2322;1016
80;2021-03-02;169;6;2491;1022
80;2021-03-03;173;4;2664;1026
80;2021-03-04;342;1;3006;1027
80;2021-03-05;488;5;3494;1032
80;2021-03-06;464;9;3958;1041
80;2021-03-07;152;7;4110;1048
80;2021-03-08;77;30;4187;1078
80;2021-03-09;223;38;4410;1116
80;2021-03-10;310;29;4720;1145
80;2021-03-11;353;14;5073;1159
80;2021-03-12;580;9;5653;1168
80;2021-03-13;773;10;6426;1178
80;2021-03-14;59;0;6485;1178
80;2021-03-15;127;5;6612;1183
80;2021-03-16;71;23;6683;1206
80;2021-03-17;55;23;6738;1229
80;2021-03-18;82;12;6820;1241
80;2021-03-19;273;37;7093;1278
80;2021-03-20;664;3;7757;1281
80;2021-03-21;75;0;7832;1281
80;2021-03-22;135;10;7967;1291
80;2021-03-23;266;11;8233;1302
80;2021-03-24;288;15;8521;1317
80;2021-03-25;401;19;8922;1336
80;2021-03-26;497;22;9419;1358
80;2021-03-27;333;13;9752;1371
80;2021-03-28;73;9;9825;1380
80;2021-03-29;233;52;10058;1432
80;2021-03-30;296;35;10354;1467
80;2021-03-31;212;42;10566;1509
80;2021-04-01;264;70;10830;1579
81;2020-12-28;0;0;0;0
81;2020-12-29;0;0;0;0
81;2020-12-30;0;0;0;0
81;2020-12-31;0;0;0;0
81;2021-01-01;0;0;0;0
81;2021-01-02;0;0;0;0
81;2021-01-03;0;0;0;0
81;2021-01-04;0;0;0;0
81;2021-01-05;0;0;0;0
81;2021-01-06;0;0;0;0
81;2021-01-07;6;0;6;0
81;2021-01-08;40;0;46;0
81;2021-01-09;16;0;62;0
81;2021-01-10;0;0;62;0
81;2021-01-11;17;0;79;0
81;2021-01-12;23;0;102;0
81;2021-01-13;21;0;123;0
81;2021-01-14;69;0;192;0
81;2021-01-15;65;0;257;0
81;2021-01-16;15;0;272;0
81;2021-01-17;0;0;272;0
81;2021-01-18;31;0;303;0
81;2021-01-19;40;0;343;0
81;2021-01-20;38;0;381;0
81;2021-01-21;67;0;448;0
81;2021-01-22;49;0;497;0
81;2021-01-23;11;0;508;0
81;2021-01-24;5;0;513;0
81;2021-01-25;23;0;536;0
81;2021-01-26;37;0;573;0
81;2021-01-27;30;0;603;0
81;2021-01-28;34;6;637;6
81;2021-01-29;15;24;652;30
81;2021-01-30;15;10;667;40
81;2021-01-31;4;0;671;40
81;2021-02-01;17;20;688;60
81;2021-02-02;26;16;714;76
81;2021-02-03;32;26;746;102
81;2021-02-04;61;50;807;152
81;2021-02-05;60;34;867;186
81;2021-02-06;20;5;887;191
81;2021-02-07;4;0;891;191
81;2021-02-08;6;19;897;210
81;2021-02-09;26;40;923;250
81;2021-02-10;20;18;943;268
81;2021-02-11;31;45;974;313
81;2021-02-12;41;39;1015;352
81;2021-02-13;9;9;1024;361
81;2021-02-14;4;0;1028;361
81;2021-02-15;21;32;1049;393
81;2021-02-16;20;34;1069;427
81;2021-02-17;16;18;1085;445
81;2021-02-18;29;43;1114;488
81;2021-02-19;41;27;1155;515
81;2021-02-20;13;11;1168;526
81;2021-02-21;0;5;1168;531
81;2021-02-22;31;25;1199;556
81;2021-02-23;12;32;1211;588
81;2021-02-24;24;20;1235;608
81;2021-02-25;112;52;1347;660
81;2021-02-26;175;54;1522;714
81;2021-02-27;99;13;1621;727
81;2021-02-28;0;4;1621;731
81;2021-03-01;60;33;1681;764
81;2021-03-02;111;26;1792;790
81;2021-03-03;120;26;1912;816
81;2021-03-04;261;29;2173;845
81;2021-03-05;320;19;2493;864
81;2021-03-06;161;9;2654;873
81;2021-03-07;15;4;2669;877
81;2021-03-08;85;18;2754;895
81;2021-03-09;109;25;2863;920
81;2021-03-10;107;22;2970;942
81;2021-03-11;217;21;3187;963
81;2021-03-12;282;18;3469;981
81;2021-03-13;121;7;3590;988
81;2021-03-14;4;3;3594;991
81;2021-03-15;95;12;3689;1003
81;2021-03-16;56;19;3745;1022
81;2021-03-17;47;11;3792;1033
81;2021-03-18;61;35;3853;1068
81;2021-03-19;133;27;3986;1095
81;2021-03-20;83;3;4069;1098
81;2021-03-21;6;0;4075;1098
81;2021-03-22;89;33;4164;1131
81;2021-03-23;137;9;4301;1140
81;2021-03-24;175;17;4476;1157
81;2021-03-25;195;16;4671;1173
81;2021-03-26;220;14;4891;1187
81;2021-03-27;137;0;5028;1187
81;2021-03-28;68;1;5096;1188
81;2021-03-29;291;12;5387;1200
81;2021-03-30;323;14;5710;1214
81;2021-03-31;306;21;6016;1235
81;2021-04-01;358;17;6374;1252
82;2020-12-28;0;0;0;0
82;2020-12-29;0;0;0;0
82;2020-12-30;0;0;0;0
82;2020-12-31;0;0;0;0
82;2021-01-01;0;0;0;0
82;2021-01-02;0;0;0;0
82;2021-01-03;0;0;0;0
82;2021-01-04;0;0;0;0
82;2021-01-05;1;0;1;0
82;2021-01-06;0;0;1;0
82;2021-01-07;8;0;9;0
82;2021-01-08;5;0;14;0
82;2021-01-09;13;0;27;0
82;2021-01-10;0;0;27;0
82;2021-01-11;10;0;37;0
82;2021-01-12;23;0;60;0
82;2021-01-13;52;0;112;0
82;2021-01-14;40;0;152;0
82;2021-01-15;44;0;196;0
82;2021-01-16;21;0;217;0
82;2021-01-17;1;0;218;0
82;2021-01-18;20;0;238;0
82;2021-01-19;19;0;257;0
82;2021-01-20;18;0;275;0
82;2021-01-21;20;0;295;0
82;2021-01-22;20;0;315;0
82;2021-01-23;6;0;321;0
82;2021-01-24;0;0;321;0
82;2021-01-25;17;0;338;0
82;2021-01-26;22;0;360;0
82;2021-01-27;18;0;378;0
82;2021-01-28;29;5;407;5
82;2021-01-29;22;1;429;6
82;2021-01-30;0;5;429;11
82;2021-01-31;0;0;429;11
82;2021-02-01;10;11;439;22
82;2021-02-02;12;10;451;32
82;2021-02-03;18;9;469;41
82;2021-02-04;43;17;512;58
82;2021-02-05;25;10;537;68
82;2021-02-06;8;3;545;71
82;2021-02-07;3;14;548;85
82;2021-02-08;3;26;551;111
82;2021-02-09;9;20;560;131
82;2021-02-10;8;37;568;168
82;2021-02-11;8;38;576;206
82;2021-02-12;16;29;592;235
82;2021-02-13;8;7;600;242
82;2021-02-14;1;3;601;245
82;2021-02-15;11;15;612;260
82;2021-02-16;12;17;624;277
82;2021-02-17;19;18;643;295
82;2021-02-18;30;29;673;324
82;2021-02-19;36;28;709;352
82;2021-02-20;1;7;710;359
82;2021-02-21;0;0;710;359
82;2021-02-22;13;22;723;381
82;2021-02-23;20;16;743;397
82;2021-02-24;10;16;753;413
82;2021-02-25;65;38;818;451
82;2021-02-26;108;16;926;467
82;2021-02-27;72;0;998;467
82;2021-02-28;11;0;1009;467
82;2021-03-01;25;15;1034;482
82;2021-03-02;92;17;1126;499
82;2021-03-03;53;10;1179;509
82;2021-03-04;118;12;1297;521
82;2021-03-05;119;18;1416;539
82;2021-03-06;114;5;1530;544
82;2021-03-07;50;0;1580;544
82;2021-03-08;83;6;1663;550
82;2021-03-09;54;11;1717;561
82;2021-03-10;87;9;1804;570
82;2021-03-11;111;12;1915;582
82;2021-03-12;149;5;2064;587
82;2021-03-13;139;6;2203;593
82;2021-03-14;15;0;2218;593
82;2021-03-15;43;16;2261;609
82;2021-03-16;6;20;2267;629
82;2021-03-17;12;19;2279;648
82;2021-03-18;11;19;2290;667
82;2021-03-19;58;11;2348;678
82;2021-03-20;39;4;2387;682
82;2021-03-21;7;0;2394;682
82;2021-03-22;45;17;2439;699
82;2021-03-23;56;15;2495;714
82;2021-03-24;70;12;2565;726
82;2021-03-25;112;12;2677;738
82;2021-03-26;167;14;2844;752
82;2021-03-27;72;4;2916;756
82;2021-03-28;28;0;2944;756
82;2021-03-29;85;21;3029;777
82;2021-03-30;123;10;3152;787
82;2021-03-31;92;10;3244;797
82;2021-04-01;112;9;3356;806
83;2020-12-28;0;0;0;0
83;2020-12-29;0;0;0;0
83;2020-12-30;0;0;0;0
83;2020-12-31;0;0;0;0
83;2021-01-01;0;0;0;0
83;2021-01-02;0;0;0;0
83;2021-01-03;0;0;0;0
83;2021-01-04;0;0;0;0
83;2021-01-05;0;0;0;0
83;2021-01-06;3;0;3;0
83;2021-01-07;46;0;49;0
83;2021-01-08;54;0;103;0
83;2021-01-09;10;0;113;0
83;2021-01-10;0;0;113;0
83;2021-01-11;59;0;172;0
83;2021-01-12;91;0;263;0
83;2021-01-13;84;0;347;0
83;2021-01-14;100;0;447;0
83;2021-01-15;59;0;506;0
83;2021-01-16;0;0;506;0
83;2021-01-17;0;0;506;0
83;2021-01-18;74;0;580;0
83;2021-01-19;108;0;688;0
83;2021-01-20;117;0;805;0
83;2021-01-21;125;0;930;0
83;2021-01-22;115;0;1045;0
83;2021-01-23;15;0;1060;0
83;2021-01-24;0;0;1060;0
83;2021-01-25;84;0;1144;0
83;2021-01-26;87;1;1231;1
83;2021-01-27;141;4;1372;5
83;2021-01-28;278;46;1650;51
83;2021-01-29;215;43;1865;94
83;2021-01-30;15;6;1880;100
83;2021-01-31;6;0;1886;100
83;2021-02-01;56;54;1942;154
83;2021-02-02;59;76;2001;230
83;2021-02-03;62;76;2063;306
83;2021-02-04;79;78;2142;384
83;2021-02-05;60;69;2202;453
83;2021-02-06;1;0;2203;453
83;2021-02-07;0;0;2203;453
83;2021-02-08;45;64;2248;517
83;2021-02-09;63;83;2311;600
83;2021-02-10;86;95;2397;695
83;2021-02-11;102;82;2499;777
83;2021-02-12;77;102;2576;879
83;2021-02-13;7;2;2583;881
83;2021-02-14;0;0;2583;881
83;2021-02-15;56;54;2639;935
83;2021-02-16;39;71;2678;1006
83;2021-02-17;67;145;2745;1151
83;2021-02-18;127;241;2872;1392
83;2021-02-19;121;177;2993;1569
83;2021-02-20;9;15;3002;1584
83;2021-02-21;0;1;3002;1585
83;2021-02-22;28;79;3030;1664
83;2021-02-23;56;64;3086;1728
83;2021-02-24;50;71;3136;1799
83;2021-02-25;224;62;3360;1861
83;2021-02-26;318;58;3678;1919
83;2021-02-27;252;4;3930;1923
83;2021-02-28;2;0;3932;1923
83;2021-03-01;93;48;4025;1971
83;2021-03-02;143;50;4168;2021
83;2021-03-03;257;73;4425;2094
83;2021-03-04;353;79;4778;2173
83;2021-03-05;400;64;5178;2237
83;2021-03-06;426;7;5604;2244
83;2021-03-07;144;0;5748;2244
83;2021-03-08;108;69;5856;2313
83;2021-03-09;236;51;6092;2364
83;2021-03-10;337;83;6429;2447
83;2021-03-11;556;139;6985;2586
83;2021-03-12;495;94;7480;2680
83;2021-03-13;507;15;7987;2695
83;2021-03-14;135;0;8122;2695
83;2021-03-15;277;36;8399;2731
83;2021-03-16;171;55;8570;2786
83;2021-03-17;183;60;8753;2846
83;2021-03-18;206;82;8959;2928
83;2021-03-19;365;46;9324;2974
83;2021-03-20;323;1;9647;2975
83;2021-03-21;197;0;9844;2975
83;2021-03-22;340;38;10184;3013
83;2021-03-23;413;41;10597;3054
83;2021-03-24;459;36;11056;3090
83;2021-03-25;660;88;11716;3178
83;2021-03-26;718;35;12434;3213
83;2021-03-27;434;11;12868;3224
83;2021-03-28;177;0;13045;3224
83;2021-03-29;458;33;13503;3257
83;2021-03-30;583;48;14086;3305
83;2021-03-31;540;48;14626;3353
83;2021-04-01;531;87;15157;3440
84;2020-12-28;0;0;0;0
84;2020-12-29;0;0;0;0
84;2020-12-30;0;0;0;0
84;2020-12-31;0;0;0;0
84;2021-01-01;0;0;0;0
84;2021-01-02;0;0;0;0
84;2021-01-03;0;0;0;0
84;2021-01-04;0;0;0;0
84;2021-01-05;0;0;0;0
84;2021-01-06;0;0;0;0
84;2021-01-07;1;0;1;0
84;2021-01-08;8;0;9;0
84;2021-01-09;1;0;10;0
84;2021-01-10;0;0;10;0
84;2021-01-11;16;0;26;0
84;2021-01-12;47;0;73;0
84;2021-01-13;30;0;103;0
84;2021-01-14;65;0;168;0
84;2021-01-15;53;0;221;0
84;2021-01-16;12;1;233;1
84;2021-01-17;4;0;237;1
84;2021-01-18;34;0;271;1
84;2021-01-19;47;0;318;1
84;2021-01-20;42;0;360;1
84;2021-01-21;54;0;414;1
84;2021-01-22;71;0;485;1
84;2021-01-23;25;0;510;1
84;2021-01-24;0;0;510;1
84;2021-01-25;28;0;538;1
84;2021-01-26;39;0;577;1
84;2021-01-27;43;0;620;1
84;2021-01-28;66;0;686;1
84;2021-01-29;59;9;745;10
84;2021-01-30;7;1;752;11
84;2021-01-31;1;0;753;11
84;2021-02-01;32;8;785;19
84;2021-02-02;39;29;824;48
84;2021-02-03;70;24;894;72
84;2021-02-04;55;29;949;101
84;2021-02-05;46;24;995;125
84;2021-02-06;6;5;1001;130
84;2021-02-07;0;0;1001;130
84;2021-02-08;31;23;1032;153
84;2021-02-09;31;41;1063;194
84;2021-02-10;24;21;1087;215
84;2021-02-11;46;45;1133;260
84;2021-02-12;35;44;1168;304
84;2021-02-13;4;9;1172;313
84;2021-02-14;0;0;1172;313
84;2021-02-15;10;37;1182;350
84;2021-02-16;8;41;1190;391
84;2021-02-17;50;37;1240;428
84;2021-02-18;52;66;1292;494
84;2021-02-19;48;53;1340;547
84;2021-02-20;2;11;1342;558
84;2021-02-21;1;1;1343;559
84;2021-02-22;30;35;1373;594
84;2021-02-23;28;38;1401;632
84;2021-02-24;30;52;1431;684
84;2021-02-25;172;31;1603;715
84;2021-02-26;220;42;1823;757
84;2021-02-27;47;6;1870;763
84;2021-02-28;6;0;1876;763
84;2021-03-01;55;28;1931;791
84;2021-03-02;98;46;2029;837
84;2021-03-03;114;58;2143;895
84;2021-03-04;205;50;2348;945
84;2021-03-05;233;49;2581;994
84;2021-03-06;220;4;2801;998
84;2021-03-07;70;0;2871;998
84;2021-03-08;99;24;2970;1022
84;2021-03-09;168;15;3138;1037
84;2021-03-10;158;31;3296;1068
84;2021-03-11;292;32;3588;1100
84;2021-03-12;289;34;3877;1134
84;2021-03-13;117;1;3994;1135
84;2021-03-14;34;0;4028;1135
84;2021-03-15;103;7;4131;1142
84;2021-03-16;51;25;4182;1167
84;2021-03-17;69;46;4251;1213
84;2021-03-18;93;30;4344;1243
84;2021-03-19;210;36;4554;1279
84;2021-03-20;118;0;4672;1279
84;2021-03-21;27;0;4699;1279
84;2021-03-22;130;32;4829;1311
84;2021-03-23;187;32;5016;1343
84;2021-03-24;237;20;5253;1363
84;2021-03-25;419;20;5672;1383
84;2021-03-26;420;24;6092;1407
84;2021-03-27;134;2;6226;1409
84;2021-03-28;18;0;6244;1409
84;2021-03-29;183;16;6427;1425
84;2021-03-30;258;25;6685;1450
84;2021-03-31;300;20;6985;1470
84;2021-04-01;336;33;7321;1503
85;2020-12-28;0;0;0;0
85;2020-12-29;0;0;0;0
85;2020-12-30;0;0;0;0
85;2020-12-31;0;0;0;0
85;2021-01-01;0;0;0;0
85;2021-01-02;0;0;0;0
85;2021-01-03;0;0;0;0
85;2021-01-04;2;0;2;0
85;2021-01-05;5;0;7;0
85;2021-01-06;13;0;20;0
85;2021-01-07;11;0;31;0
85;2021-01-08;24;0;55;0
85;2021-01-09;42;0;97;0
85;2021-01-10;7;0;104;0
85;2021-01-11;51;0;155;0
85;2021-01-12;60;0;215;0
85;2021-01-13;61;0;276;0
85;2021-01-14;70;0;346;0
85;2021-01-15;64;0;410;0
85;2021-01-16;28;0;438;0
85;2021-01-17;4;0;442;0
85;2021-01-18;30;0;472;0
85;2021-01-19;74;0;546;0
85;2021-01-20;68;0;614;0
85;2021-01-21;112;0;726;0
85;2021-01-22;62;1;788;1
85;2021-01-23;19;0;807;1
85;2021-01-24;2;0;809;1
85;2021-01-25;16;0;825;1
85;2021-01-26;31;4;856;5
85;2021-01-27;52;2;908;7
85;2021-01-28;46;2;954;9
85;2021-01-29;36;2;990;11
85;2021-01-30;6;2;996;13
85;2021-01-31;0;7;996;20
85;2021-02-01;13;9;1009;29
85;2021-02-02;20;13;1029;42
85;2021-02-03;11;18;1040;60
85;2021-02-04;30;28;1070;88
85;2021-02-05;17;16;1087;104
85;2021-02-06;5;31;1092;135
85;2021-02-07;0;0;1092;135
85;2021-02-08;13;49;1105;184
85;2021-02-09;22;94;1127;278
85;2021-02-10;33;78;1160;356
85;2021-02-11;67;140;1227;496
85;2021-02-12;53;83;1280;579
85;2021-02-13;7;46;1287;625
85;2021-02-14;0;2;1287;627
85;2021-02-15;8;37;1295;664
85;2021-02-16;41;57;1336;721
85;2021-02-17;58;75;1394;796
85;2021-02-18;82;67;1476;863
85;2021-02-19;54;41;1530;904
85;2021-02-20;13;12;1543;916
85;2021-02-21;0;0;1543;916
85;2021-02-22;33;15;1576;931
85;2021-02-23;57;16;1633;947
85;2021-02-24;88;7;1721;954
85;2021-02-25;310;11;2031;965
85;2021-02-26;300;21;2331;986
85;2021-02-27;206;4;2537;990
85;2021-02-28;1;0;2538;990
85;2021-03-01;83;11;2621;1001
85;2021-03-02;125;23;2746;1024
85;2021-03-03;148;20;2894;1044
85;2021-03-04;309;58;3203;1102
85;2021-03-05;379;47;3582;1149
85;2021-03-06;247;6;3829;1155
85;2021-03-07;25;0;3854;1155
85;2021-03-08;146;14;4000;1169
85;2021-03-09;222;25;4222;1194
85;2021-03-10;180;29;4402;1223
85;2021-03-11;370;48;4772;1271
85;2021-03-12;382;28;5154;1299
85;2021-03-13;265;5;5419;1304
85;2021-03-14;39;0;5458;1304
85;2021-03-15;145;23;5603;1327
85;2021-03-16;73;43;5676;1370
85;2021-03-17;67;37;5743;1407
85;2021-03-18;110;30;5853;1437
85;2021-03-19;253;13;6106;1450
85;2021-03-20;136;10;6242;1460
85;2021-03-21;21;0;6263;1460
85;2021-03-22;143;29;6406;1489
85;2021-03-23;261;64;6667;1553
85;2021-03-24;280;22;6947;1575
85;2021-03-25;380;28;7327;1603
85;2021-03-26;434;25;7761;1628
85;2021-03-27;144;5;7905;1633
85;2021-03-28;32;0;7937;1633
85;2021-03-29;233;31;8170;1664
85;2021-03-30;226;43;8396;1707
85;2021-03-31;205;26;8601;1733
85;2021-04-01;331;60;8932;1793
86;2020-12-28;0;0;0;0
86;2020-12-29;0;0;0;0
86;2020-12-30;0;0;0;0
86;2020-12-31;0;0;0;0
86;2021-01-01;0;0;0;0
86;2021-01-02;0;0;0;0
86;2021-01-03;0;0;0;0
86;2021-01-04;0;0;0;0
86;2021-01-05;0;0;0;0
86;2021-01-06;18;0;18;0
86;2021-01-07;64;0;82;0
86;2021-01-08;78;0;160;0
86;2021-01-09;0;0;160;0
86;2021-01-10;11;0;171;0
86;2021-01-11;31;0;202;0
86;2021-01-12;51;0;253;0
86;2021-01-13;49;0;302;0
86;2021-01-14;52;0;354;0
86;2021-01-15;56;0;410;0
86;2021-01-16;0;0;410;0
86;2021-01-17;0;0;410;0
86;2021-01-18;31;0;441;0
86;2021-01-19;80;0;521;0
86;2021-01-20;62;0;583;0
86;2021-01-21;61;0;644;0
86;2021-01-22;36;0;680;0
86;2021-01-23;16;0;696;0
86;2021-01-24;0;0;696;0
86;2021-01-25;26;14;722;14
86;2021-01-26;27;24;749;38
86;2021-01-27;30;27;779;65
86;2021-01-28;44;41;823;106
86;2021-01-29;46;28;869;134
86;2021-01-30;10;6;879;140
86;2021-01-31;4;9;883;149
86;2021-02-01;23;27;906;176
86;2021-02-02;28;39;934;215
86;2021-02-03;30;34;964;249
86;2021-02-04;26;71;990;320
86;2021-02-05;20;62;1010;382
86;2021-02-06;12;12;1022;394
86;2021-02-07;0;0;1022;394
86;2021-02-08;23;19;1045;413
86;2021-02-09;43;54;1088;467
86;2021-02-10;41;53;1129;520
86;2021-02-11;72;50;1201;570
86;2021-02-12;40;12;1241;582
86;2021-02-13;14;4;1255;586
86;2021-02-14;0;0;1255;586
86;2021-02-15;6;22;1261;608
86;2021-02-16;27;35;1288;643
86;2021-02-17;31;30;1319;673
86;2021-02-18;25;47;1344;720
86;2021-02-19;35;26;1379;746
86;2021-02-20;9;11;1388;757
86;2021-02-21;0;0;1388;757
86;2021-02-22;7;10;1395;767
86;2021-02-23;12;27;1407;794
86;2021-02-24;53;20;1460;814
86;2021-02-25;267;22;1727;836
86;2021-02-26;293;34;2020;870
86;2021-02-27;129;4;2149;874
86;2021-02-28;0;0;2149;874
86;2021-03-01;51;37;2200;911
86;2021-03-02;238;53;2438;964
86;2021-03-03;166;33;2604;997
86;2021-03-04;309;43;2913;1040
86;2021-03-05;377;20;3290;1060
86;2021-03-06;194;6;3484;1066
86;2021-03-07;25;0;3509;1066
86;2021-03-08;55;27;3564;1093
86;2021-03-09;206;34;3770;1127
86;2021-03-10;161;28;3931;1155
86;2021-03-11;278;34;4209;1189
86;2021-03-12;371;19;4580;1208
86;2021-03-13;251;5;4831;1213
86;2021-03-14;6;0;4837;1213
86;2021-03-15;68;13;4905;1226
86;2021-03-16;44;10;4949;1236
86;2021-03-17;48;24;4997;1260
86;2021-03-18;73;9;5070;1269
86;2021-03-19;183;13;5253;1282
86;2021-03-20;96;12;5349;1294
86;2021-03-21;1;0;5350;1294
86;2021-03-22;84;18;5434;1312
86;2021-03-23;221;7;5655;1319
86;2021-03-24;194;34;5849;1353
86;2021-03-25;286;26;6135;1379
86;2021-03-26;343;29;6478;1408
86;2021-03-27;55;8;6533;1416
86;2021-03-28;1;6;6534;1422
86;2021-03-29;151;16;6685;1438
86;2021-03-30;264;53;6949;1491
86;2021-03-31;183;39;7132;1530
86;2021-04-01;223;41;7355;1571
87;2020-12-28;0;0;0;0
87;2020-12-29;0;0;0;0
87;2020-12-30;0;0;0;0
87;2020-12-31;0;0;0;0
87;2021-01-01;0;0;0;0
87;2021-01-02;0;0;0;0
87;2021-01-03;0;0;0;0
87;2021-01-04;0;0;0;0
87;2021-01-05;0;0;0;0
87;2021-01-06;3;0;3;0
87;2021-01-07;26;0;29;0
87;2021-01-08;25;0;54;0
87;2021-01-09;3;0;57;0
87;2021-01-10;1;0;58;0
87;2021-01-11;33;0;91;0
87;2021-01-12;42;0;133;0
87;2021-01-13;43;0;176;0
87;2021-01-14;37;0;213;0
87;2021-01-15;43;0;256;0
87;2021-01-16;18;0;274;0
87;2021-01-17;0;0;274;0
87;2021-01-18;31;0;305;0
87;2021-01-19;29;0;334;0
87;2021-01-20;36;0;370;0
87;2021-01-21;32;0;402;0
87;2021-01-22;41;0;443;0
87;2021-01-23;15;0;458;0
87;2021-01-24;0;0;458;0
87;2021-01-25;24;3;482;3
87;2021-01-26;27;6;509;9
87;2021-01-27;19;6;528;15
87;2021-01-28;31;19;559;34
87;2021-01-29;24;17;583;51
87;2021-01-30;14;4;597;55
87;2021-01-31;1;4;598;59
87;2021-02-01;20;25;618;84
87;2021-02-02;21;32;639;116
87;2021-02-03;27;38;666;154
87;2021-02-04;30;33;696;187
87;2021-02-05;18;36;714;223
87;2021-02-06;6;20;720;243
87;2021-02-07;0;0;720;243
87;2021-02-08;15;24;735;267
87;2021-02-09;8;27;743;294
87;2021-02-10;18;25;761;319
87;2021-02-11;12;30;773;349
87;2021-02-12;18;34;791;383
87;2021-02-13;1;14;792;397
87;2021-02-14;0;0;792;397
87;2021-02-15;24;15;816;412
87;2021-02-16;14;16;830;428
87;2021-02-17;23;21;853;449
87;2021-02-18;27;20;880;469
87;2021-02-19;36;29;916;498
87;2021-02-20;3;10;919;508
87;2021-02-21;0;0;919;508
87;2021-02-22;23;24;942;532
87;2021-02-23;27;21;969;553
87;2021-02-24;25;15;994;568
87;2021-02-25;164;29;1158;597
87;2021-02-26;205;14;1363;611
87;2021-02-27;167;7;1530;618
87;2021-02-28;0;0;1530;618
87;2021-03-01;62;14;1592;632
87;2021-03-02;170;15;1762;647
87;2021-03-03;194;17;1956;664
87;2021-03-04;246;25;2202;689
87;2021-03-05;367;24;2569;713
87;2021-03-06;232;2;2801;715
87;2021-03-07;25;0;2826;715
87;2021-03-08;85;15;2911;730
87;2021-03-09;152;12;3063;742
87;2021-03-10;147;13;3210;755
87;2021-03-11;199;13;3409;768
87;2021-03-12;295;19;3704;787
87;2021-03-13;224;0;3928;787
87;2021-03-14;15;0;3943;787
87;2021-03-15;78;29;4021;816
87;2021-03-16;27;7;4048;823
87;2021-03-17;37;24;4085;847
87;2021-03-18;41;20;4126;867
87;2021-03-19;111;27;4237;894
87;2021-03-20;92;3;4329;897
87;2021-03-21;3;0;4332;897
87;2021-03-22;80;20;4412;917
87;2021-03-23;94;24;4506;941
87;2021-03-24;103;20;4609;961
87;2021-03-25;165;38;4774;999
87;2021-03-26;194;17;4968;1016
87;2021-03-27;77;5;5045;1021
87;2021-03-28;16;0;5061;1021
87;2021-03-29;83;25;5144;1046
87;2021-03-30;158;36;5302;1082
87;2021-03-31;139;24;5441;1106
87;2021-04-01;143;13;5584;1119
88;2020-12-28;0;0;0;0
88;2020-12-29;0;0;0;0
88;2020-12-30;0;0;0;0
88;2020-12-31;0;0;0;0
88;2021-01-01;0;0;0;0
88;2021-01-02;0;0;0;0
88;2021-01-03;0;0;0;0
88;2021-01-04;0;0;0;0
88;2021-01-05;0;0;0;0
88;2021-01-06;0;0;0;0
88;2021-01-07;8;0;8;0
88;2021-01-08;15;0;23;0
88;2021-01-09;6;0;29;0
88;2021-01-10;0;0;29;0
88;2021-01-11;9;0;38;0
88;2021-01-12;28;0;66;0
88;2021-01-13;41;0;107;0
88;2021-01-14;30;0;137;0
88;2021-01-15;29;0;166;0
88;2021-01-16;4;0;170;0
88;2021-01-17;0;0;170;0
88;2021-01-18;10;0;180;0
88;2021-01-19;14;0;194;0
88;2021-01-20;20;0;214;0
88;2021-01-21;54;0;268;0
88;2021-01-22;50;0;318;0
88;2021-01-23;7;0;325;0
88;2021-01-24;6;0;331;0
88;2021-01-25;50;1;381;1
88;2021-01-26;18;0;399;1
88;2021-01-27;1;0;400;1
88;2021-01-28;10;7;410;8
88;2021-01-29;42;7;452;15
88;2021-01-30;8;8;460;23
88;2021-01-31;0;0;460;23
88;2021-02-01;18;12;478;35
88;2021-02-02;8;15;486;50
88;2021-02-03;20;24;506;74
88;2021-02-04;21;15;527;89
88;2021-02-05;28;18;555;107
88;2021-02-06;6;7;561;114
88;2021-02-07;0;0;561;114
88;2021-02-08;21;15;582;129
88;2021-02-09;13;21;595;150
88;2021-02-10;18;15;613;165
88;2021-02-11;41;56;654;221
88;2021-02-12;61;41;715;262
88;2021-02-13;5;4;720;266
88;2021-02-14;3;5;723;271
88;2021-02-15;34;46;757;317
88;2021-02-16;24;26;781;343
88;2021-02-17;31;16;812;359
88;2021-02-18;36;13;848;372
88;2021-02-19;19;20;867;392
88;2021-02-20;18;4;885;396
88;2021-02-21;0;0;885;396
88;2021-02-22;31;16;916;412
88;2021-02-23;37;9;953;421
88;2021-02-24;40;14;993;435
88;2021-02-25;117;12;1110;447
88;2021-02-26;276;17;1386;464
88;2021-02-27;90;9;1476;473
88;2021-02-28;10;0;1486;473
88;2021-03-01;64;15;1550;488
88;2021-03-02;95;16;1645;504
88;2021-03-03;109;18;1754;522
88;2021-03-04;156;43;1910;565
88;2021-03-05;220;40;2130;605
88;2021-03-06;212;2;2342;607
88;2021-03-07;149;2;2491;609
88;2021-03-08;116;40;2607;649
88;2021-03-09;168;25;2775;674
88;2021-03-10;183;15;2958;689
88;2021-03-11;226;13;3184;702
88;2021-03-12;234;36;3418;738
88;2021-03-13;190;19;3608;757
88;2021-03-14;23;0;3631;757
88;2021-03-15;101;24;3732;781
88;2021-03-16;80;13;3812;794
88;2021-03-17;63;26;3875;820
88;2021-03-18;92;18;3967;838
88;2021-03-19;164;17;4131;855
88;2021-03-20;167;1;4298;856
88;2021-03-21;2;0;4300;856
88;2021-03-22;159;37;4459;893
88;2021-03-23;201;29;4660;922
88;2021-03-24;225;33;4885;955
88;2021-03-25;324;27;5209;982
88;2021-03-26;356;24;5565;1006
88;2021-03-27;140;13;5705;1019
88;2021-03-28;5;0;5710;1019
88;2021-03-29;151;33;5861;1052
88;2021-03-30;239;26;6100;1078
88;2021-03-31;184;28;6284;1106
88;2021-04-01;242;38;6526;1144
89;2020-12-28;0;0;0;0
89;2020-12-29;0;0;0;0
89;2020-12-30;0;0;0;0
89;2020-12-31;0;0;0;0
89;2021-01-01;0;0;0;0
89;2021-01-02;0;0;0;0
89;2021-01-03;0;0;0;0
89;2021-01-04;0;0;0;0
89;2021-01-05;0;0;0;0
89;2021-01-06;3;0;3;0
89;2021-01-07;12;0;15;0
89;2021-01-08;10;0;25;0
89;2021-01-09;0;0;25;0
89;2021-01-10;0;0;25;0
89;2021-01-11;16;0;41;0
89;2021-01-12;26;0;67;0
89;2021-01-13;50;0;117;0
89;2021-01-14;69;0;186;0
89;2021-01-15;28;0;214;0
89;2021-01-16;15;1;229;1
89;2021-01-17;0;0;229;1
89;2021-01-18;49;0;278;1
89;2021-01-19;72;0;350;1
89;2021-01-20;48;0;398;1
89;2021-01-21;64;0;462;1
89;2021-01-22;76;0;538;1
89;2021-01-23;10;0;548;1
89;2021-01-24;1;0;549;1
89;2021-01-25;29;0;578;1
89;2021-01-26;25;1;603;2
89;2021-01-27;34;3;637;5
89;2021-01-28;35;12;672;17
89;2021-01-29;57;8;729;25
89;2021-01-30;7;1;736;26
89;2021-01-31;0;0;736;26
89;2021-02-01;15;32;751;58
89;2021-02-02;13;46;764;104
89;2021-02-03;20;36;784;140
89;2021-02-04;18;30;802;170
89;2021-02-05;31;28;833;198
89;2021-02-06;3;9;836;207
89;2021-02-07;0;0;836;207
89;2021-02-08;17;23;853;230
89;2021-02-09;18;42;871;272
89;2021-02-10;22;25;893;297
89;2021-02-11;22;62;915;359
89;2021-02-12;39;52;954;411
89;2021-02-13;4;10;958;421
89;2021-02-14;2;2;960;423
89;2021-02-15;19;27;979;450
89;2021-02-16;3;45;982;495
89;2021-02-17;13;21;995;516
89;2021-02-18;9;29;1004;545
89;2021-02-19;13;59;1017;604
89;2021-02-20;1;4;1018;608
89;2021-02-21;0;0;1018;608
89;2021-02-22;11;32;1029;640
89;2021-02-23;5;16;1034;656
89;2021-02-24;23;36;1057;692
89;2021-02-25;101;26;1158;718
89;2021-02-26;87;22;1245;740
89;2021-02-27;66;3;1311;743
89;2021-02-28;1;0;1312;743
89;2021-03-01;71;9;1383;752
89;2021-03-02;106;14;1489;766
89;2021-03-03;80;14;1569;780
89;2021-03-04;90;16;1659;796
89;2021-03-05;114;42;1773;838
89;2021-03-06;143;3;1916;841
89;2021-03-07;48;3;1964;844
89;2021-03-08;47;12;2011;856
89;2021-03-09;102;9;2113;865
89;2021-03-10;98;15;2211;880
89;2021-03-11;129;15;2340;895
89;2021-03-12;199;26;2539;921
89;2021-03-13;126;1;2665;922
89;2021-03-14;0;0;2665;922
89;2021-03-15;66;13;2731;935
89;2021-03-16;66;5;2797;940
89;2021-03-17;49;5;2846;945
89;2021-03-18;57;6;2903;951
89;2021-03-19;123;9;3026;960
89;2021-03-20;147;0;3173;960
89;2021-03-21;24;0;3197;960
89;2021-03-22;110;9;3307;969
89;2021-03-23;200;13;3507;982
89;2021-03-24;214;12;3721;994
89;2021-03-25;248;12;3969;1006
89;2021-03-26;335;11;4304;1017
89;2021-03-27;237;2;4541;1019
89;2021-03-28;2;0;4543;1019
89;2021-03-29;124;31;4667;1050
89;2021-03-30;151;22;4818;1072
89;2021-03-31;242;18;5060;1090
89;2021-04-01;274;22;5334;1112
90;2020-12-28;0;0;0;0
90;2020-12-29;0;0;0;0
90;2020-12-30;0;0;0;0
90;2020-12-31;0;0;0;0
90;2021-01-01;0;0;0;0
90;2021-01-02;0;0;0;0
90;2021-01-03;0;0;0;0
90;2021-01-04;0;0;0;0
90;2021-01-05;0;0;0;0
90;2021-01-06;0;0;0;0
90;2021-01-07;0;0;0;0
90;2021-01-08;18;0;18;0
90;2021-01-09;3;0;21;0
90;2021-01-10;0;0;21;0
90;2021-01-11;24;0;45;0
90;2021-01-12;24;0;69;0
90;2021-01-13;38;0;107;0
90;2021-01-14;43;0;150;0
90;2021-01-15;46;0;196;0
90;2021-01-16;15;0;211;0
90;2021-01-17;0;0;211;0
90;2021-01-18;31;0;242;0
90;2021-01-19;22;0;264;0
90;2021-01-20;40;0;304;0
90;2021-01-21;25;0;329;0
90;2021-01-22;17;0;346;0
90;2021-01-23;4;0;350;0
90;2021-01-24;0;0;350;0
90;2021-01-25;18;0;368;0
90;2021-01-26;9;0;377;0
90;2021-01-27;4;0;381;0
90;2021-01-28;27;1;408;1
90;2021-01-29;23;16;431;17
90;2021-01-30;20;9;451;26
90;2021-01-31;20;0;471;26
90;2021-02-01;18;18;489;44
90;2021-02-02;16;17;505;61
90;2021-02-03;23;34;528;95
90;2021-02-04;15;29;543;124
90;2021-02-05;19;17;562;141
90;2021-02-06;7;9;569;150
90;2021-02-07;0;0;569;150
90;2021-02-08;8;13;577;163
90;2021-02-09;8;17;585;180
90;2021-02-10;9;15;594;195
90;2021-02-11;13;18;607;213
90;2021-02-12;6;20;613;233
90;2021-02-13;6;6;619;239
90;2021-02-14;0;0;619;239
90;2021-02-15;8;40;627;279
90;2021-02-16;8;27;635;306
90;2021-02-17;10;5;645;311
90;2021-02-18;8;9;653;320
90;2021-02-19;5;15;658;335
90;2021-02-20;1;2;659;337
90;2021-02-21;0;0;659;337
90;2021-02-22;6;12;665;349
90;2021-02-23;1;9;666;358
90;2021-02-24;11;12;677;370
90;2021-02-25;24;17;701;387
90;2021-02-26;46;30;747;417
90;2021-02-27;65;11;812;428
90;2021-02-28;2;19;814;447
90;2021-03-01;22;12;836;459
90;2021-03-02;41;18;877;477
90;2021-03-03;57;22;934;499
90;2021-03-04;48;15;982;514
90;2021-03-05;90;17;1072;531
90;2021-03-06;84;9;1156;540
90;2021-03-07;4;0;1160;540
90;2021-03-08;25;13;1185;553
90;2021-03-09;57;9;1242;562
90;2021-03-10;62;15;1304;577
90;2021-03-11;69;3;1373;580
90;2021-03-12;135;10;1508;590
90;2021-03-13;151;2;1659;592
90;2021-03-14;2;0;1661;592
90;2021-03-15;33;4;1694;596
90;2021-03-16;40;7;1734;603
90;2021-03-17;37;1;1771;604
90;2021-03-18;38;5;1809;609
90;2021-03-19;55;6;1864;615
90;2021-03-20;83;1;1947;616
90;2021-03-21;0;0;1947;616
90;2021-03-22;50;0;1997;616
90;2021-03-23;107;5;2104;621
90;2021-03-24;117;4;2221;625
90;2021-03-25;147;4;2368;629
90;2021-03-26;183;1;2551;630
90;2021-03-27;70;0;2621;630
90;2021-03-28;3;0;2624;630
90;2021-03-29;114;12;2738;642
90;2021-03-30;104;14;2842;656
90;2021-03-31;98;3;2940;659
90;2021-04-01;86;1;3026;660
91;2020-12-28;0;0;0;0
91;2020-12-29;0;0;0;0
91;2020-12-30;0;0;0;0
91;2020-12-31;0;0;0;0
91;2021-01-01;1;0;1;0
91;2021-01-02;0;0;1;0
91;2021-01-03;0;0;1;0
91;2021-01-04;0;0;1;0
91;2021-01-05;3;0;4;0
91;2021-01-06;22;0;26;0
91;2021-01-07;47;0;73;0
91;2021-01-08;41;0;114;0
91;2021-01-09;13;0;127;0
91;2021-01-10;0;0;127;0
91;2021-01-11;63;0;190;0
91;2021-01-12;114;0;304;0
91;2021-01-13;106;0;410;0
91;2021-01-14;96;0;506;0
91;2021-01-15;60;0;566;0
91;2021-01-16;56;1;622;1
91;2021-01-17;16;0;638;1
91;2021-01-18;76;0;714;1
91;2021-01-19;130;0;844;1
91;2021-01-20;151;0;995;1
91;2021-01-21;107;0;1102;1
91;2021-01-22;81;0;1183;1
91;2021-01-23;14;0;1197;1
91;2021-01-24;0;0;1197;1
91;2021-01-25;46;2;1243;3
91;2021-01-26;65;2;1308;5
91;2021-01-27;71;7;1379;12
91;2021-01-28;92;12;1471;24
91;2021-01-29;85;8;1556;32
91;2021-01-30;30;0;1586;32
91;2021-01-31;1;0;1587;32
91;2021-02-01;33;21;1620;53
91;2021-02-02;37;57;1657;110
91;2021-02-03;26;77;1683;187
91;2021-02-04;34;56;1717;243
91;2021-02-05;43;43;1760;286
91;2021-02-06;14;14;1774;300
91;2021-02-07;0;0;1774;300
91;2021-02-08;42;72;1816;372
91;2021-02-09;44;101;1860;473
91;2021-02-10;66;96;1926;569
91;2021-02-11;71;96;1997;665
91;2021-02-12;43;70;2040;735
91;2021-02-13;13;56;2053;791
91;2021-02-14;1;11;2054;802
91;2021-02-15;23;57;2077;859
91;2021-02-16;39;125;2116;984
91;2021-02-17;58;163;2174;1147
91;2021-02-18;67;101;2241;1248
91;2021-02-19;82;83;2323;1331
91;2021-02-20;14;19;2337;1350
91;2021-02-21;0;2;2337;1352
91;2021-02-22;13;33;2350;1385
91;2021-02-23;20;27;2370;1412
91;2021-02-24;37;31;2407;1443
91;2021-02-25;192;28;2599;1471
91;2021-02-26;313;35;2912;1506
91;2021-02-27;186;15;3098;1521
91;2021-02-28;14;1;3112;1522
91;2021-03-01;139;39;3251;1561
91;2021-03-02;252;49;3503;1610
91;2021-03-03;280;50;3783;1660
91;2021-03-04;453;59;4236;1719
91;2021-03-05;577;47;4813;1766
91;2021-03-06;825;13;5638;1779
91;2021-03-07;271;1;5909;1780
91;2021-03-08;163;42;6072;1822
91;2021-03-09;391;30;6463;1852
91;2021-03-10;320;49;6783;1901
91;2021-03-11;601;64;7384;1965
91;2021-03-12;744;56;8128;2021
91;2021-03-13;790;7;8918;2028
91;2021-03-14;32;1;8950;2029
91;2021-03-15;313;8;9263;2037
91;2021-03-16;224;16;9487;2053
91;2021-03-17;145;17;9632;2070
91;2021-03-18;214;17;9846;2087
91;2021-03-19;535;12;10381;2099
91;2021-03-20;617;2;10998;2101
91;2021-03-21;21;0;11019;2101
91;2021-03-22;376;23;11395;2124
91;2021-03-23;619;29;12014;2153
91;2021-03-24;593;22;12607;2175
91;2021-03-25;816;19;13423;2194
91;2021-03-26;973;25;14396;2219
91;2021-03-27;769;8;15165;2227
91;2021-03-28;45;4;15210;2231
91;2021-03-29;446;61;15656;2292
91;2021-03-30;632;60;16288;2352
91;2021-03-31;475;52;16763;2404
91;2021-04-01;468;62;17231;2466
92;2020-12-28;0;0;0;0
92;2020-12-29;1;0;1;0
92;2020-12-30;3;0;4;0
92;2020-12-31;0;0;4;0
92;2021-01-01;2;0;6;0
92;2021-01-02;0;0;6;0
92;2021-01-03;0;0;6;0
92;2021-01-04;6;0;12;0
92;2021-01-05;17;0;29;0
92;2021-01-06;34;0;63;0
92;2021-01-07;71;0;134;0
92;2021-01-08;79;0;213;0
92;2021-01-09;9;0;222;0
92;2021-01-10;5;0;227;0
92;2021-01-11;80;0;307;0
92;2021-01-12;126;0;433;0
92;2021-01-13;147;0;580;0
92;2021-01-14;121;0;701;0
92;2021-01-15;94;0;795;0
92;2021-01-16;23;0;818;0
92;2021-01-17;0;0;818;0
92;2021-01-18;82;0;900;0
92;2021-01-19;76;1;976;1
92;2021-01-20;114;0;1090;1
92;2021-01-21;177;0;1267;1
92;2021-01-22;158;3;1425;4
92;2021-01-23;15;0;1440;4
92;2021-01-24;2;0;1442;4
92;2021-01-25;38;2;1480;6
92;2021-01-26;42;0;1522;6
92;2021-01-27;113;7;1635;13
92;2021-01-28;190;30;1825;43
92;2021-01-29;153;23;1978;66
92;2021-01-30;28;2;2006;68
92;2021-01-31;0;0;2006;68
92;2021-02-01;39;41;2045;109
92;2021-02-02;43;41;2088;150
92;2021-02-03;26;58;2114;208
92;2021-02-04;46;66;2160;274
92;2021-02-05;55;50;2215;324
92;2021-02-06;4;2;2219;326
92;2021-02-07;0;1;2219;327
92;2021-02-08;18;64;2237;391
92;2021-02-09;64;127;2301;518
92;2021-02-10;65;135;2366;653
92;2021-02-11;61;172;2427;825
92;2021-02-12;86;111;2513;936
92;2021-02-13;6;11;2519;947
92;2021-02-14;0;0;2519;947
92;2021-02-15;37;79;2556;1026
92;2021-02-16;47;106;2603;1132
92;2021-02-17;39;117;2642;1249
92;2021-02-18;111;197;2753;1446
92;2021-02-19;118;147;2871;1593
92;2021-02-20;9;13;2880;1606
92;2021-02-21;2;1;2882;1607
92;2021-02-22;35;67;2917;1674
92;2021-02-23;39;66;2956;1740
92;2021-02-24;42;65;2998;1805
92;2021-02-25;192;84;3190;1889
92;2021-02-26;343;72;3533;1961
92;2021-02-27;189;6;3722;1967
92;2021-02-28;20;0;3742;1967
92;2021-03-01;136;45;3878;2012
92;2021-03-02;287;53;4165;2065
92;2021-03-03;412;36;4577;2101
92;2021-03-04;677;77;5254;2178
92;2021-03-05;928;62;6182;2240
92;2021-03-06;699;5;6881;2245
92;2021-03-07;184;0;7065;2245
92;2021-03-08;345;28;7410;2273
92;2021-03-09;523;39;7933;2312
92;2021-03-10;527;36;8460;2348
92;2021-03-11;721;80;9181;2428
92;2021-03-12;1136;84;10317;2512
92;2021-03-13;844;2;11161;2514
92;2021-03-14;190;2;11351;2516
92;2021-03-15;457;16;11808;2532
92;2021-03-16;279;16;12087;2548
92;2021-03-17;284;7;12371;2555
92;2021-03-18;347;21;12718;2576
92;2021-03-19;667;31;13385;2607
92;2021-03-20;384;1;13769;2608
92;2021-03-21;34;0;13803;2608
92;2021-03-22;507;25;14310;2633
92;2021-03-23;907;33;15217;2666
92;2021-03-24;900;11;16117;2677
92;2021-03-25;1216;29;17333;2706
92;2021-03-26;1182;42;18515;2748
92;2021-03-27;433;40;18948;2788
92;2021-03-28;54;1;19002;2789
92;2021-03-29;637;32;19639;2821
92;2021-03-30;792;57;20431;2878
92;2021-03-31;717;145;21148;3023
92;2021-04-01;751;168;21899;3191
93;2020-12-28;0;0;0;0
93;2020-12-29;0;0;0;0
93;2020-12-30;3;0;3;0
93;2020-12-31;0;0;3;0
93;2021-01-01;0;0;3;0
93;2021-01-02;0;0;3;0
93;2021-01-03;0;0;3;0
93;2021-01-04;0;0;3;0
93;2021-01-05;9;0;12;0
93;2021-01-06;36;0;48;0
93;2021-01-07;33;0;81;0
93;2021-01-08;87;0;168;0
93;2021-01-09;1;0;169;0
93;2021-01-10;0;0;169;0
93;2021-01-11;59;0;228;0
93;2021-01-12;102;0;330;0
93;2021-01-13;114;0;444;0
93;2021-01-14;96;0;540;0
93;2021-01-15;78;0;618;0
93;2021-01-16;15;1;633;1
93;2021-01-17;1;0;634;1
93;2021-01-18;74;0;708;1
93;2021-01-19;131;0;839;1
93;2021-01-20;110;0;949;1
93;2021-01-21;126;0;1075;1
93;2021-01-22;145;0;1220;1
93;2021-01-23;40;0;1260;1
93;2021-01-24;0;0;1260;1
93;2021-01-25;101;0;1361;1
93;2021-01-26;88;9;1449;10
93;2021-01-27;122;11;1571;21
93;2021-01-28;146;27;1717;48
93;2021-01-29;87;28;1804;76
93;2021-01-30;51;3;1855;79
93;2021-01-31;0;0;1855;79
93;2021-02-01;79;44;1934;123
93;2021-02-02;107;60;2041;183
93;2021-02-03;128;64;2169;247
93;2021-02-04;71;92;2240;339
93;2021-02-05;46;83;2286;422
93;2021-02-06;42;7;2328;429
93;2021-02-07;0;0;2328;429
93;2021-02-08;69;53;2397;482
93;2021-02-09;53;74;2450;556
93;2021-02-10;46;94;2496;650
93;2021-02-11;104;65;2600;715
93;2021-02-12;78;75;2678;790
93;2021-02-13;35;24;2713;814
93;2021-02-14;1;0;2714;814
93;2021-02-15;25;77;2739;891
93;2021-02-16;36;107;2775;998
93;2021-02-17;34;133;2809;1131
93;2021-02-18;93;110;2902;1241
93;2021-02-19;71;116;2973;1357
93;2021-02-20;40;39;3013;1396
93;2021-02-21;0;1;3013;1397
93;2021-02-22;45;75;3058;1472
93;2021-02-23;29;69;3087;1541
93;2021-02-24;87;84;3174;1625
93;2021-02-25;171;70;3345;1695
93;2021-02-26;241;50;3586;1745
93;2021-02-27;185;36;3771;1781
93;2021-02-28;36;1;3807;1782
93;2021-03-01;170;57;3977;1839
93;2021-03-02;248;102;4225;1941
93;2021-03-03;276;103;4501;2044
93;2021-03-04;486;79;4987;2123
93;2021-03-05;671;49;5658;2172
93;2021-03-06;754;29;6412;2201
93;2021-03-07;394;0;6806;2201
93;2021-03-08;249;53;7055;2254
93;2021-03-09;464;56;7519;2310
93;2021-03-10;422;63;7941;2373
93;2021-03-11;523;87;8464;2460
93;2021-03-12;710;77;9174;2537
93;2021-03-13;705;39;9879;2576
93;2021-03-14;128;0;10007;2576
93;2021-03-15;492;25;10499;2601
93;2021-03-16;405;41;10904;2642
93;2021-03-17;334;31;11238;2673
93;2021-03-18;482;27;11720;2700
93;2021-03-19;566;37;12286;2737
93;2021-03-20;576;9;12862;2746
93;2021-03-21;142;0;13004;2746
93;2021-03-22;612;23;13616;2769
93;2021-03-23;801;27;14417;2796
93;2021-03-24;798;32;15215;2828
93;2021-03-25;1029;32;16244;2860
93;2021-03-26;979;34;17223;2894
93;2021-03-27;769;10;17992;2904
93;2021-03-28;74;1;18066;2905
93;2021-03-29;560;32;18626;2937
93;2021-03-30;744;58;19370;2995
93;2021-03-31;601;67;19971;3062
93;2021-04-01;589;214;20560;3276
94;2020-12-28;1;0;1;0
94;2020-12-29;0;0;1;0
94;2020-12-30;0;0;1;0
94;2020-12-31;0;0;1;0
94;2021-01-01;0;0;1;0
94;2021-01-02;0;0;1;0
94;2021-01-03;0;0;1;0
94;2021-01-04;2;0;3;0
94;2021-01-05;14;0;17;0
94;2021-01-06;31;0;48;0
94;2021-01-07;56;0;104;0
94;2021-01-08;96;0;200;0
94;2021-01-09;1;0;201;0
94;2021-01-10;1;0;202;0
94;2021-01-11;117;0;319;0
94;2021-01-12;125;0;444;0
94;2021-01-13;154;0;598;0
94;2021-01-14;192;0;790;0
94;2021-01-15;146;0;936;0
94;2021-01-16;23;0;959;0
94;2021-01-17;10;0;969;0
94;2021-01-18;125;0;1094;0
94;2021-01-19;164;0;1258;0
94;2021-01-20;147;0;1405;0
94;2021-01-21;175;0;1580;0
94;2021-01-22;176;0;1756;0
94;2021-01-23;30;0;1786;0
94;2021-01-24;14;0;1800;0
94;2021-01-25;102;2;1902;2
94;2021-01-26;99;1;2001;3
94;2021-01-27;99;1;2100;4
94;2021-01-28;106;13;2206;17
94;2021-01-29;86;13;2292;30
94;2021-01-30;22;1;2314;31
94;2021-01-31;10;0;2324;31
94;2021-02-01;58;12;2382;43
94;2021-02-02;37;26;2419;69
94;2021-02-03;37;54;2456;123
94;2021-02-04;38;62;2494;185
94;2021-02-05;45;107;2539;292
94;2021-02-06;19;15;2558;307
94;2021-02-07;3;3;2561;310
94;2021-02-08;28;98;2589;408
94;2021-02-09;39;157;2628;565
94;2021-02-10;85;151;2713;716
94;2021-02-11;60;194;2773;910
94;2021-02-12;80;178;2853;1088
94;2021-02-13;34;18;2887;1106
94;2021-02-14;4;4;2891;1110
94;2021-02-15;25;111;2916;1221
94;2021-02-16;50;111;2966;1332
94;2021-02-17;61;153;3027;1485
94;2021-02-18;60;198;3087;1683
94;2021-02-19;99;134;3186;1817
94;2021-02-20;13;22;3199;1839
94;2021-02-21;1;4;3200;1843
94;2021-02-22;35;86;3235;1929
94;2021-02-23;35;85;3270;2014
94;2021-02-24;49;80;3319;2094
94;2021-02-25;164;49;3483;2143
94;2021-02-26;309;53;3792;2196
94;2021-02-27;220;21;4012;2217
94;2021-02-28;23;7;4035;2224
94;2021-03-01;130;58;4165;2282
94;2021-03-02;238;55;4403;2337
94;2021-03-03;280;49;4683;2386
94;2021-03-04;497;65;5180;2451
94;2021-03-05;686;67;5866;2518
94;2021-03-06;675;22;6541;2540
94;2021-03-07;289;5;6830;2545
94;2021-03-08;227;39;7057;2584
94;2021-03-09;350;33;7407;2617
94;2021-03-10;469;41;7876;2658
94;2021-03-11;609;34;8485;2692
94;2021-03-12;794;50;9279;2742
94;2021-03-13;697;16;9976;2758
94;2021-03-14;268;8;10244;2766
94;2021-03-15;392;19;10636;2785
94;2021-03-16;287;33;10923;2818
94;2021-03-17;194;25;11117;2843
94;2021-03-18;305;19;11422;2862
94;2021-03-19;570;70;11992;2932
94;2021-03-20;549;16;12541;2948
94;2021-03-21;169;1;12710;2949
94;2021-03-22;404;42;13114;2991
94;2021-03-23;708;31;13822;3022
94;2021-03-24;659;40;14481;3062
94;2021-03-25;940;50;15421;3112
94;2021-03-26;927;52;16348;3164
94;2021-03-27;757;4;17105;3168
94;2021-03-28;249;5;17354;3173
94;2021-03-29;490;51;17844;3224
94;2021-03-30;631;58;18475;3282
94;2021-03-31;563;64;19038;3346
94;2021-04-01;661;121;19699;3467
95;2020-12-28;0;0;0;0
95;2020-12-29;0;0;0;0
95;2020-12-30;0;0;0;0
95;2020-12-31;0;0;0;0
95;2021-01-01;0;0;0;0
95;2021-01-02;0;0;0;0
95;2021-01-03;0;0;0;0
95;2021-01-04;0;0;0;0
95;2021-01-05;15;0;15;0
95;2021-01-06;30;0;45;0
95;2021-01-07;17;0;62;0
95;2021-01-08;35;0;97;0
95;2021-01-09;44;0;141;0
95;2021-01-10;58;0;199;0
95;2021-01-11;48;0;247;0
95;2021-01-12;91;0;338;0
95;2021-01-13;83;0;421;0
95;2021-01-14;98;0;519;0
95;2021-01-15;83;0;602;0
95;2021-01-16;26;2;628;2
95;2021-01-17;28;0;656;2
95;2021-01-18;76;0;732;2
95;2021-01-19;86;0;818;2
95;2021-01-20;128;0;946;2
95;2021-01-21;127;1;1073;3
95;2021-01-22;95;0;1168;3
95;2021-01-23;45;0;1213;3
95;2021-01-24;7;0;1220;3
95;2021-01-25;28;0;1248;3
95;2021-01-26;49;3;1297;6
95;2021-01-27;67;31;1364;37
95;2021-01-28;100;1;1464;38
95;2021-01-29;85;23;1549;61
95;2021-01-30;18;0;1567;61
95;2021-01-31;13;0;1580;61
95;2021-02-01;34;26;1614;87
95;2021-02-02;31;47;1645;134
95;2021-02-03;30;70;1675;204
95;2021-02-04;52;35;1727;239
95;2021-02-05;35;38;1762;277
95;2021-02-06;11;45;1773;322
95;2021-02-07;9;65;1782;387
95;2021-02-08;43;63;1825;450
95;2021-02-09;59;101;1884;551
95;2021-02-10;90;134;1974;685
95;2021-02-11;103;121;2077;806
95;2021-02-12;70;79;2147;885
95;2021-02-13;19;26;2166;911
95;2021-02-14;1;23;2167;934
95;2021-02-15;50;50;2217;984
95;2021-02-16;61;54;2278;1038
95;2021-02-17;61;76;2339;1114
95;2021-02-18;80;115;2419;1229
95;2021-02-19;58;74;2477;1303
95;2021-02-20;15;21;2492;1324
95;2021-02-21;13;12;2505;1336
95;2021-02-22;35;40;2540;1376
95;2021-02-23;46;28;2586;1404
95;2021-02-24;24;49;2610;1453
95;2021-02-25;198;51;2808;1504
95;2021-02-26;223;40;3031;1544
95;2021-02-27;185;17;3216;1561
95;2021-02-28;9;12;3225;1573
95;2021-03-01;94;26;3319;1599
95;2021-03-02;152;43;3471;1642
95;2021-03-03;283;46;3754;1688
95;2021-03-04;553;71;4307;1759
95;2021-03-05;641;64;4948;1823
95;2021-03-06;631;13;5579;1836
95;2021-03-07;336;10;5915;1846
95;2021-03-08;219;41;6134;1887
95;2021-03-09;335;28;6469;1915
95;2021-03-10;363;45;6832;1960
95;2021-03-11;583;53;7415;2013
95;2021-03-12;612;31;8027;2044
95;2021-03-13;681;11;8708;2055
95;2021-03-14;231;11;8939;2066
95;2021-03-15;317;20;9256;2086
95;2021-03-16;145;35;9401;2121
95;2021-03-17;197;23;9598;2144
95;2021-03-18;289;24;9887;2168
95;2021-03-19;463;14;10350;2182
95;2021-03-20;378;4;10728;2186
95;2021-03-21;116;10;10844;2196
95;2021-03-22;502;27;11346;2223
95;2021-03-23;619;30;11965;2253
95;2021-03-24;639;26;12604;2279
95;2021-03-25;937;53;13541;2332
95;2021-03-26;843;23;14384;2355
95;2021-03-27;660;3;15044;2358
95;2021-03-28;217;5;15261;2363
95;2021-03-29;451;26;15712;2389
95;2021-03-30;606;101;16318;2490
95;2021-03-31;488;120;16806;2610
95;2021-04-01;747;112;17553;2722
971;2020-12-28;0;0;0;0
971;2020-12-29;0;0;0;0
971;2020-12-30;0;0;0;0
971;2020-12-31;0;0;0;0
971;2021-01-01;0;0;0;0
971;2021-01-02;0;0;0;0
971;2021-01-03;0;0;0;0
971;2021-01-04;0;0;0;0
971;2021-01-05;0;0;0;0
971;2021-01-06;0;0;0;0
971;2021-01-07;0;0;0;0
971;2021-01-08;0;0;0;0
971;2021-01-09;1;0;1;0
971;2021-01-10;0;0;1;0
971;2021-01-11;0;0;1;0
971;2021-01-12;5;0;6;0
971;2021-01-13;3;0;9;0
971;2021-01-14;5;0;14;0
971;2021-01-15;4;0;18;0
971;2021-01-16;0;0;18;0
971;2021-01-17;0;0;18;0
971;2021-01-18;7;0;25;0
971;2021-01-19;11;0;36;0
971;2021-01-20;10;0;46;0
971;2021-01-21;11;0;57;0
971;2021-01-22;13;0;70;0
971;2021-01-23;0;0;70;0
971;2021-01-24;0;0;70;0
971;2021-01-25;3;0;73;0
971;2021-01-26;11;0;84;0
971;2021-01-27;23;0;107;0
971;2021-01-28;13;1;120;1
971;2021-01-29;11;0;131;1
971;2021-01-30;0;0;131;1
971;2021-01-31;0;0;131;1
971;2021-02-01;8;1;139;2
971;2021-02-02;18;5;157;7
971;2021-02-03;8;1;165;8
971;2021-02-04;14;2;179;10
971;2021-02-05;13;5;192;15
971;2021-02-06;0;0;192;15
971;2021-02-07;0;0;192;15
971;2021-02-08;6;1;198;16
971;2021-02-09;17;12;215;28
971;2021-02-10;14;12;229;40
971;2021-02-11;22;7;251;47
971;2021-02-12;22;6;273;53
971;2021-02-13;0;0;273;53
971;2021-02-14;0;0;273;53
971;2021-02-15;12;0;285;53
971;2021-02-16;2;0;287;53
971;2021-02-17;0;0;287;53
971;2021-02-18;23;2;310;55
971;2021-02-19;29;6;339;61
971;2021-02-20;0;0;339;61
971;2021-02-21;0;0;339;61
971;2021-02-22;8;6;347;67
971;2021-02-23;22;9;369;76
971;2021-02-24;33;12;402;88
971;2021-02-25;44;10;446;98
971;2021-02-26;21;7;467;105
971;2021-02-27;0;0;467;105
971;2021-02-28;0;0;467;105
971;2021-03-01;6;4;473;109
971;2021-03-02;13;18;486;127
971;2021-03-03;11;9;497;136
971;2021-03-04;16;14;513;150
971;2021-03-05;19;14;532;164
971;2021-03-06;8;0;540;164
971;2021-03-07;0;0;540;164
971;2021-03-08;13;8;553;172
971;2021-03-09;38;13;591;185
971;2021-03-10;49;16;640;201
971;2021-03-11;31;3;671;204
971;2021-03-12;22;21;693;225
971;2021-03-13;4;0;697;225
971;2021-03-14;1;0;698;225
971;2021-03-15;19;2;717;227
971;2021-03-16;29;8;746;235
971;2021-03-17;23;33;769;268
971;2021-03-18;47;39;816;307
971;2021-03-19;31;13;847;320
971;2021-03-20;0;0;847;320
971;2021-03-21;0;0;847;320
971;2021-03-22;13;4;860;324
971;2021-03-23;38;16;898;340
971;2021-03-24;26;8;924;348
971;2021-03-25;78;19;1002;367
971;2021-03-26;60;13;1062;380
971;2021-03-27;37;0;1099;380
971;2021-03-28;0;0;1099;380
971;2021-03-29;24;8;1123;388
971;2021-03-30;56;15;1179;403
971;2021-03-31;41;14;1220;417
971;2021-04-01;46;19;1266;436
972;2020-12-28;0;0;0;0
972;2020-12-29;0;0;0;0
972;2020-12-30;0;0;0;0
972;2020-12-31;0;0;0;0
972;2021-01-01;0;0;0;0
972;2021-01-02;0;0;0;0
972;2021-01-03;0;0;0;0
972;2021-01-04;0;0;0;0
972;2021-01-05;0;0;0;0
972;2021-01-06;3;0;3;0
972;2021-01-07;6;0;9;0
972;2021-01-08;9;0;18;0
972;2021-01-09;1;0;19;0
972;2021-01-10;0;0;19;0
972;2021-01-11;11;0;30;0
972;2021-01-12;5;0;35;0
972;2021-01-13;7;0;42;0
972;2021-01-14;8;0;50;0
972;2021-01-15;15;0;65;0
972;2021-01-16;7;0;72;0
972;2021-01-17;0;0;72;0
972;2021-01-18;10;0;82;0
972;2021-01-19;11;0;93;0
972;2021-01-20;13;0;106;0
972;2021-01-21;15;0;121;0
972;2021-01-22;18;0;139;0
972;2021-01-23;2;0;141;0
972;2021-01-24;0;0;141;0
972;2021-01-25;11;0;152;0
972;2021-01-26;16;0;168;0
972;2021-01-27;22;3;190;3
972;2021-01-28;11;4;201;7
972;2021-01-29;16;8;217;15
972;2021-01-30;10;0;227;15
972;2021-01-31;0;0;227;15
972;2021-02-01;8;9;235;24
972;2021-02-02;18;7;253;31
972;2021-02-03;9;4;262;35
972;2021-02-04;15;5;277;40
972;2021-02-05;7;9;284;49
972;2021-02-06;4;0;288;49
972;2021-02-07;0;0;288;49
972;2021-02-08;6;5;294;54
972;2021-02-09;15;12;309;66
972;2021-02-10;12;7;321;73
972;2021-02-11;13;13;334;86
972;2021-02-12;11;15;345;101
972;2021-02-13;2;3;347;104
972;2021-02-14;0;0;347;104
972;2021-02-15;5;2;352;106
972;2021-02-16;0;0;352;106
972;2021-02-17;0;0;352;106
972;2021-02-18;9;11;361;117
972;2021-02-19;9;10;370;127
972;2021-02-20;0;7;370;134
972;2021-02-21;0;0;370;134
972;2021-02-22;7;11;377;145
972;2021-02-23;8;27;385;172
972;2021-02-24;12;15;397;187
972;2021-02-25;8;13;405;200
972;2021-02-26;10;18;415;218
972;2021-02-27;9;2;424;220
972;2021-02-28;0;0;424;220
972;2021-03-01;21;14;445;234
972;2021-03-02;25;9;470;243
972;2021-03-03;13;8;483;251
972;2021-03-04;17;13;500;264
972;2021-03-05;22;13;522;277
972;2021-03-06;11;6;533;283
972;2021-03-07;11;0;544;283
972;2021-03-08;14;10;558;293
972;2021-03-09;26;11;584;304
972;2021-03-10;37;12;621;316
972;2021-03-11;38;4;659;320
972;2021-03-12;41;4;700;324
972;2021-03-13;14;1;714;325
972;2021-03-14;1;0;715;325
972;2021-03-15;33;5;748;330
972;2021-03-16;24;7;772;337
972;2021-03-17;36;0;808;337
972;2021-03-18;49;3;857;340
972;2021-03-19;28;6;885;346
972;2021-03-20;20;1;905;347
972;2021-03-21;7;0;912;347
972;2021-03-22;50;11;962;358
972;2021-03-23;44;13;1006;371
972;2021-03-24;56;11;1062;382
972;2021-03-25;65;8;1127;390
972;2021-03-26;79;9;1206;399
972;2021-03-27;22;8;1228;407
972;2021-03-28;9;0;1237;407
972;2021-03-29;54;15;1291;422
972;2021-03-30;62;20;1353;442
972;2021-03-31;139;15;1492;457
972;2021-04-01;104;16;1596;473
973;2020-12-28;0;0;0;0
973;2020-12-29;0;0;0;0
973;2020-12-30;0;0;0;0
973;2020-12-31;0;0;0;0
973;2021-01-01;0;0;0;0
973;2021-01-02;0;0;0;0
973;2021-01-03;0;0;0;0
973;2021-01-04;0;0;0;0
973;2021-01-05;0;0;0;0
973;2021-01-06;0;0;0;0
973;2021-01-07;0;0;0;0
973;2021-01-08;0;0;0;0
973;2021-01-09;0;0;0;0
973;2021-01-10;0;0;0;0
973;2021-01-11;0;0;0;0
973;2021-01-12;0;0;0;0
973;2021-01-13;2;0;2;0
973;2021-01-14;4;0;6;0
973;2021-01-15;3;0;9;0
973;2021-01-16;2;0;11;0
973;2021-01-17;0;0;11;0
973;2021-01-18;6;0;17;0
973;2021-01-19;11;0;28;0
973;2021-01-20;22;0;50;0
973;2021-01-21;3;0;53;0
973;2021-01-22;10;0;63;0
973;2021-01-23;0;0;63;0
973;2021-01-24;0;0;63;0
973;2021-01-25;7;0;70;0
973;2021-01-26;10;0;80;0
973;2021-01-27;16;0;96;0
973;2021-01-28;17;0;113;0
973;2021-01-29;14;0;127;0
973;2021-01-30;0;0;127;0
973;2021-01-31;0;0;127;0
973;2021-02-01;13;0;140;0
973;2021-02-02;20;0;160;0
973;2021-02-03;24;1;184;1
973;2021-02-04;18;3;202;4
973;2021-02-05;10;1;212;5
973;2021-02-06;0;0;212;5
973;2021-02-07;0;0;212;5
973;2021-02-08;8;2;220;7
973;2021-02-09;11;3;231;10
973;2021-02-10;26;13;257;23
973;2021-02-11;20;3;277;26
973;2021-02-12;22;2;299;28
973;2021-02-13;0;0;299;28
973;2021-02-14;0;0;299;28
973;2021-02-15;5;7;304;35
973;2021-02-16;21;4;325;39
973;2021-02-17;21;14;346;53
973;2021-02-18;9;13;355;66
973;2021-02-19;20;9;375;75
973;2021-02-20;0;0;375;75
973;2021-02-21;0;0;375;75
973;2021-02-22;9;9;384;84
973;2021-02-23;18;10;402;94
973;2021-02-24;30;15;432;109
973;2021-02-25;32;18;464;127
973;2021-02-26;37;9;501;136
973;2021-02-27;12;0;513;136
973;2021-02-28;0;0;513;136
973;2021-03-01;24;16;537;152
973;2021-03-02;27;16;564;168
973;2021-03-03;37;30;601;198
973;2021-03-04;34;16;635;214
973;2021-03-05;32;9;667;223
973;2021-03-06;15;0;682;223
973;2021-03-07;0;0;682;223
973;2021-03-08;32;7;714;230
973;2021-03-09;47;11;761;241
973;2021-03-10;50;30;811;271
973;2021-03-11;32;21;843;292
973;2021-03-12;31;22;874;314
973;2021-03-13;13;0;887;314
973;2021-03-14;0;0;887;314
973;2021-03-15;25;2;912;316
973;2021-03-16;45;16;957;332
973;2021-03-17;40;16;997;348
973;2021-03-18;30;15;1027;363
973;2021-03-19;31;18;1058;381
973;2021-03-20;26;2;1084;383
973;2021-03-21;0;0;1084;383
973;2021-03-22;29;11;1113;394
973;2021-03-23;25;28;1138;422
973;2021-03-24;19;17;1157;439
973;2021-03-25;17;20;1174;459
973;2021-03-26;16;31;1190;490
973;2021-03-27;5;15;1195;505
973;2021-03-28;0;0;1195;505
973;2021-03-29;16;32;1211;537
973;2021-03-30;35;24;1246;561
973;2021-03-31;31;35;1277;596
973;2021-04-01;35;31;1312;627
974;2020-12-28;0;0;0;0
974;2020-12-29;0;0;0;0
974;2020-12-30;0;0;0;0
974;2020-12-31;0;0;0;0
974;2021-01-01;0;0;0;0
974;2021-01-02;0;0;0;0
974;2021-01-03;0;0;0;0
974;2021-01-04;0;0;0;0
974;2021-01-05;0;0;0;0
974;2021-01-06;0;0;0;0
974;2021-01-07;0;0;0;0
974;2021-01-08;0;0;0;0
974;2021-01-09;1;0;1;0
974;2021-01-10;0;0;1;0
974;2021-01-11;0;0;1;0
974;2021-01-12;0;0;1;0
974;2021-01-13;0;0;1;0
974;2021-01-14;0;0;1;0
974;2021-01-15;15;0;16;0
974;2021-01-16;4;0;20;0
974;2021-01-17;0;0;20;0
974;2021-01-18;9;0;29;0
974;2021-01-19;39;0;68;0
974;2021-01-20;54;0;122;0
974;2021-01-21;102;0;224;0
974;2021-01-22;57;0;281;0
974;2021-01-23;14;0;295;0
974;2021-01-24;0;0;295;0
974;2021-01-25;25;0;320;0
974;2021-01-26;40;0;360;0
974;2021-01-27;28;0;388;0
974;2021-01-28;17;0;405;0
974;2021-01-29;30;0;435;0
974;2021-01-30;30;0;465;0
974;2021-01-31;0;0;465;0
974;2021-02-01;33;0;498;0
974;2021-02-02;40;0;538;0
974;2021-02-03;77;2;615;2
974;2021-02-04;78;2;693;4
974;2021-02-05;44;5;737;9
974;2021-02-06;42;0;779;9
974;2021-02-07;0;0;779;9
974;2021-02-08;48;5;827;14
974;2021-02-09;86;5;913;19
974;2021-02-10;97;7;1010;26
974;2021-02-11;79;13;1089;39
974;2021-02-12;61;6;1150;45
974;2021-02-13;65;3;1215;48
974;2021-02-14;0;0;1215;48
974;2021-02-15;49;15;1264;63
974;2021-02-16;70;55;1334;118
974;2021-02-17;57;49;1391;167
974;2021-02-18;44;73;1435;240
974;2021-02-19;36;49;1471;289
974;2021-02-20;66;18;1537;307
974;2021-02-21;0;0;1537;307
974;2021-02-22;42;28;1579;335
974;2021-02-23;62;26;1641;361
974;2021-02-24;65;26;1706;387
974;2021-02-25;68;12;1774;399
974;2021-02-26;71;30;1845;429
974;2021-02-27;41;33;1886;462
974;2021-02-28;0;0;1886;462
974;2021-03-01;26;33;1912;495
974;2021-03-02;37;78;1949;573
974;2021-03-03;87;86;2036;659
974;2021-03-04;77;79;2113;738
974;2021-03-05;77;39;2190;777
974;2021-03-06;88;43;2278;820
974;2021-03-07;0;0;2278;820
974;2021-03-08;54;46;2332;866
974;2021-03-09;76;52;2408;918
974;2021-03-10;85;96;2493;1014
974;2021-03-11;87;61;2580;1075
974;2021-03-12;89;68;2669;1143
974;2021-03-13;75;62;2744;1205
974;2021-03-14;0;0;2744;1205
974;2021-03-15;65;47;2809;1252
974;2021-03-16;78;73;2887;1325
974;2021-03-17;106;65;2993;1390
974;2021-03-18;127;47;3120;1437
974;2021-03-19;99;43;3219;1480
974;2021-03-20;88;57;3307;1537
974;2021-03-21;0;0;3307;1537
974;2021-03-22;73;57;3380;1594
974;2021-03-23;106;60;3486;1654
974;2021-03-24;147;72;3633;1726
974;2021-03-25;142;56;3775;1782
974;2021-03-26;162;55;3937;1837
974;2021-03-27;170;42;4107;1879
974;2021-03-28;0;0;4107;1879
974;2021-03-29;179;27;4286;1906
974;2021-03-30;149;49;4435;1955
974;2021-03-31;141;77;4576;2032
974;2021-04-01;119;80;4695;2112
976;2020-12-28;0;0;0;0
976;2020-12-29;0;0;0;0
976;2020-12-30;0;0;0;0
976;2020-12-31;0;0;0;0
976;2021-01-01;0;0;0;0
976;2021-01-02;0;0;0;0
976;2021-01-03;0;0;0;0
976;2021-01-04;0;0;0;0
976;2021-01-05;0;0;0;0
976;2021-01-06;0;0;0;0
976;2021-01-07;0;0;0;0
976;2021-01-08;0;0;0;0
976;2021-01-09;0;0;0;0
976;2021-01-10;0;0;0;0
976;2021-01-11;2;0;2;0
976;2021-01-12;0;0;2;0
976;2021-01-13;0;0;2;0
976;2021-01-14;0;0;2;0
976;2021-01-15;0;0;2;0
976;2021-01-16;0;0;2;0
976;2021-01-17;0;0;2;0
976;2021-01-18;0;0;2;0
976;2021-01-19;0;0;2;0
976;2021-01-20;0;0;2;0
976;2021-01-21;0;0;2;0
976;2021-01-22;0;0;2;0
976;2021-01-23;0;0;2;0
976;2021-01-24;0;0;2;0
976;2021-01-25;23;0;25;0
976;2021-01-26;15;0;40;0
976;2021-01-27;25;0;65;0
976;2021-01-28;19;0;84;0
976;2021-01-29;19;0;103;0
976;2021-01-30;43;0;146;0
976;2021-01-31;0;0;146;0
976;2021-02-01;13;0;159;0
976;2021-02-02;48;0;207;0
976;2021-02-03;33;0;240;0
976;2021-02-04;30;0;270;0
976;2021-02-05;20;0;290;0
976;2021-02-06;10;0;300;0
976;2021-02-07;0;0;300;0
976;2021-02-08;3;0;303;0
976;2021-02-09;11;0;314;0
976;2021-02-10;10;0;324;0
976;2021-02-11;17;0;341;0
976;2021-02-12;34;0;375;0
976;2021-02-13;6;0;381;0
976;2021-02-14;0;0;381;0
976;2021-02-15;34;1;415;1
976;2021-02-16;25;1;440;2
976;2021-02-17;23;0;463;2
976;2021-02-18;25;2;488;4
976;2021-02-19;23;1;511;5
976;2021-02-20;14;0;525;5
976;2021-02-21;0;0;525;5
976;2021-02-22;13;22;538;27
976;2021-02-23;21;21;559;48
976;2021-02-24;15;13;574;61
976;2021-02-25;19;29;593;90
976;2021-02-26;23;38;616;128
976;2021-02-27;0;0;616;128
976;2021-02-28;0;0;616;128
976;2021-03-01;19;39;635;167
976;2021-03-02;12;39;647;206
976;2021-03-03;14;21;661;227
976;2021-03-04;15;10;676;237
976;2021-03-05;11;8;687;245
976;2021-03-06;0;0;687;245
976;2021-03-07;0;0;687;245
976;2021-03-08;12;1;699;246
976;2021-03-09;21;0;720;246
976;2021-03-10;10;8;730;254
976;2021-03-11;8;7;738;261
976;2021-03-12;23;7;761;268
976;2021-03-13;0;0;761;268
976;2021-03-14;0;0;761;268
976;2021-03-15;14;35;775;303
976;2021-03-16;17;9;792;312
976;2021-03-17;12;11;804;323
976;2021-03-18;12;27;816;350
976;2021-03-19;6;22;822;372
976;2021-03-20;0;0;822;372
976;2021-03-21;0;0;822;372
976;2021-03-22;11;18;833;390
976;2021-03-23;11;22;844;412
976;2021-03-24;14;13;858;425
976;2021-03-25;19;18;877;443
976;2021-03-26;14;21;891;464
976;2021-03-27;1;0;892;464
976;2021-03-28;0;0;892;464
976;2021-03-29;0;0;892;464
976;2021-03-30;16;27;908;491
976;2021-03-31;15;5;923;496
976;2021-04-01;12;9;935;505
977;2020-12-28;0;0;0;0
977;2020-12-29;0;0;0;0
977;2020-12-30;0;0;0;0
977;2020-12-31;0;0;0;0
977;2021-01-01;0;0;0;0
977;2021-01-02;0;0;0;0
977;2021-01-03;0;0;0;0
977;2021-01-04;0;0;0;0
977;2021-01-05;0;0;0;0
977;2021-01-06;0;0;0;0
977;2021-01-07;0;0;0;0
977;2021-01-08;0;0;0;0
977;2021-01-09;0;0;0;0
977;2021-01-10;0;0;0;0
977;2021-01-11;0;0;0;0
977;2021-01-12;0;0;0;0
977;2021-01-13;0;0;0;0
977;2021-01-14;0;0;0;0
977;2021-01-15;0;0;0;0
977;2021-01-16;0;0;0;0
977;2021-01-17;0;0;0;0
977;2021-01-18;0;0;0;0
977;2021-01-19;0;0;0;0
977;2021-01-20;0;0;0;0
977;2021-01-21;0;0;0;0
977;2021-01-22;0;0;0;0
977;2021-01-23;0;0;0;0
977;2021-01-24;0;0;0;0
977;2021-01-25;0;0;0;0
977;2021-01-26;0;0;0;0
977;2021-01-27;0;0;0;0
977;2021-01-28;0;0;0;0
977;2021-01-29;0;0;0;0
977;2021-01-30;0;0;0;0
977;2021-01-31;0;0;0;0
977;2021-02-01;0;0;0;0
977;2021-02-02;0;0;0;0
977;2021-02-03;2;0;2;0
977;2021-02-04;0;0;2;0
977;2021-02-05;0;0;2;0
977;2021-02-06;0;0;2;0
977;2021-02-07;0;0;2;0
977;2021-02-08;0;0;2;0
977;2021-02-09;3;0;5;0
977;2021-02-10;2;0;7;0
977;2021-02-11;7;0;14;0
977;2021-02-12;1;0;15;0
977;2021-02-13;0;0;15;0
977;2021-02-14;0;0;15;0
977;2021-02-15;0;0;15;0
977;2021-02-16;0;0;15;0
977;2021-02-17;0;0;15;0
977;2021-02-18;3;0;18;0
977;2021-02-19;5;0;23;0
977;2021-02-20;0;0;23;0
977;2021-02-21;0;0;23;0
977;2021-02-22;0;0;23;0
977;2021-02-23;0;0;23;0
977;2021-02-24;0;0;23;0
977;2021-02-25;0;0;23;0
977;2021-02-26;0;2;23;2
977;2021-02-27;0;0;23;2
977;2021-02-28;0;0;23;2
977;2021-03-01;0;0;23;2
977;2021-03-02;4;0;27;2
977;2021-03-03;0;0;27;2
977;2021-03-04;3;3;30;5
977;2021-03-05;0;0;30;5
977;2021-03-06;0;0;30;5
977;2021-03-07;0;0;30;5
977;2021-03-08;0;0;30;5
977;2021-03-09;1;0;31;5
977;2021-03-10;0;0;31;5
977;2021-03-11;2;2;33;7
977;2021-03-12;5;0;38;7
977;2021-03-13;0;0;38;7
977;2021-03-14;1;0;39;7
977;2021-03-15;0;0;39;7
977;2021-03-16;6;2;45;9
977;2021-03-17;0;0;45;9
977;2021-03-18;4;2;49;11
977;2021-03-19;2;4;51;15
977;2021-03-20;0;0;51;15
977;2021-03-21;2;0;53;15
977;2021-03-22;0;0;53;15
977;2021-03-23;0;0;53;15
977;2021-03-24;0;0;53;15
977;2021-03-25;7;1;60;16
977;2021-03-26;3;0;63;16
977;2021-03-27;0;0;63;16
977;2021-03-28;0;0;63;16
977;2021-03-29;0;0;63;16
977;2021-03-30;3;4;66;20
977;2021-03-31;2;0;68;20
977;2021-04-01;8;1;76;21
978;2020-12-28;0;0;0;0
978;2020-12-29;0;0;0;0
978;2020-12-30;0;0;0;0
978;2020-12-31;0;0;0;0
978;2021-01-01;0;0;0;0
978;2021-01-02;0;0;0;0
978;2021-01-03;0;0;0;0
978;2021-01-04;0;0;0;0
978;2021-01-05;0;0;0;0
978;2021-01-06;0;0;0;0
978;2021-01-07;0;0;0;0
978;2021-01-08;0;0;0;0
978;2021-01-09;0;0;0;0
978;2021-01-10;0;0;0;0
978;2021-01-11;0;0;0;0
978;2021-01-12;0;0;0;0
978;2021-01-13;0;0;0;0
978;2021-01-14;0;0;0;0
978;2021-01-15;0;0;0;0
978;2021-01-16;0;0;0;0
978;2021-01-17;0;0;0;0
978;2021-01-18;0;0;0;0
978;2021-01-19;0;0;0;0
978;2021-01-20;0;0;0;0
978;2021-01-21;0;0;0;0
978;2021-01-22;0;0;0;0
978;2021-01-23;0;0;0;0
978;2021-01-24;0;0;0;0
978;2021-01-25;0;0;0;0
978;2021-01-26;0;0;0;0
978;2021-01-27;0;0;0;0
978;2021-01-28;0;0;0;0
978;2021-01-29;0;0;0;0
978;2021-01-30;0;0;0;0
978;2021-01-31;0;0;0;0
978;2021-02-01;0;0;0;0
978;2021-02-02;0;0;0;0
978;2021-02-03;0;0;0;0
978;2021-02-04;6;0;6;0
978;2021-02-05;0;0;6;0
978;2021-02-06;0;0;6;0
978;2021-02-07;0;0;6;0
978;2021-02-08;0;0;6;0
978;2021-02-09;0;0;6;0
978;2021-02-10;0;0;6;0
978;2021-02-11;0;0;6;0
978;2021-02-12;0;0;6;0
978;2021-02-13;0;0;6;0
978;2021-02-14;0;0;6;0
978;2021-02-15;0;0;6;0
978;2021-02-16;0;0;6;0
978;2021-02-17;0;0;6;0
978;2021-02-18;0;0;6;0
978;2021-02-19;0;0;6;0
978;2021-02-20;0;0;6;0
978;2021-02-21;0;0;6;0
978;2021-02-22;0;0;6;0
978;2021-02-23;0;0;6;0
978;2021-02-24;4;0;10;0
978;2021-02-25;3;0;13;0
978;2021-02-26;4;0;17;0
978;2021-02-27;0;0;17;0
978;2021-02-28;0;0;17;0
978;2021-03-01;4;0;21;0
978;2021-03-02;1;4;22;4
978;2021-03-03;7;1;29;5
978;2021-03-04;2;4;31;9
978;2021-03-05;7;1;38;10
978;2021-03-06;0;0;38;10
978;2021-03-07;0;0;38;10
978;2021-03-08;4;0;42;10
978;2021-03-09;5;3;47;13
978;2021-03-10;1;3;48;16
978;2021-03-11;0;0;48;16
978;2021-03-12;7;2;55;18
978;2021-03-13;0;0;55;18
978;2021-03-14;0;0;55;18
978;2021-03-15;3;6;58;24
978;2021-03-16;8;0;66;24
978;2021-03-17;9;0;75;24
978;2021-03-18;10;2;85;26
978;2021-03-19;4;5;89;31
978;2021-03-20;0;0;89;31
978;2021-03-21;0;0;89;31
978;2021-03-22;2;4;91;35
978;2021-03-23;4;9;95;44
978;2021-03-24;2;3;97;47
978;2021-03-25;5;3;102;50
978;2021-03-26;6;2;108;52
978;2021-03-27;0;0;108;52
978;2021-03-28;0;0;108;52
978;2021-03-29;9;5;117;57
978;2021-03-30;14;1;131;58
978;2021-03-31;8;7;139;65
978;2021-04-01;7;6;146;71
